States/UTs,Crime Head,Year,Cases pending investigation from previous year,Cases reported Under 156_3 during the year,Cases reported in Police Stations during the year,Cases reported during the year,No of victims in the registered cases,No of cases withdrawn by the Govt during investigation,Cases not investigated Under 157_1_b CRPC,Cases transferred to other Police Station or Magistrate,Cases ended as final report false,Cases ended as mistake of fact or of law,Cases in ended as final report as Non Cognizable Submitted,Cases Chargesheeted Out of Cases During the Year,Cases Chargesheeted Out of Cases from Previous Year,Cases Chargesheeted,Cases Not Chargesheeted but final report Submitted,Total cases Investigated,Cases pending investigation at the end of the year,Cases pending trial from the previous year,Cases sent for trial during the year,Cases withdrawn by the Govt,Cases disposed off by Plea Bargaining,Cases for Trial during the year,Cases compounded or withdrawn,Cases in which trials were completed,Cases  convicted Out of Cases During the Year,Cases  convicted Out of Cases from Previous Year,Cases convicted,Cases Acquitted Out of Cases During the Year,Cases Acquitted Out of Cases from Previous Year,Cases Acquitted or Discharged,Cases Pending Trial at the end of the year
Andhra Pradesh,1 - Rape (Section 376 IPC),2014,602,9,952,961,962,0,0,9,31,5,0,255,395,650,13,699,855,1654,650,0,0,2304,11,469,0,59,59,3,407,410,1824
Andhra Pradesh,1.1 - Custodial Rape,2014,0,0,0,0,0,0,0,0,0,0,0,0,0,0,0,0,0,0,0,0,0,0,0,0,0,0,0,0,0,0,0
Andhra Pradesh,1.1.1 - Custodial_Gang Rape,2014,0,0,0,0,0,0,0,0,0,0,0,0,0,0,0,0,0,0,0,0,0,0,0,0,0,0,0,0,0,0,0
Andhra Pradesh,1.1.2 - Custodial_Other Rape,2014,0,0,0,0,0,0,0,0,0,0,0,0,0,0,0,0,0,0,0,0,0,0,0,0,0,0,0,0,0,0,0
Andhra Pradesh,1.2 - Rape other than Custodial,2014,602,9,952,961,962,0,0,9,31,5,0,255,395,650,13,699,855,1654,650,0,0,2304,11,469,0,59,59,3,407,410,1824
Andhra Pradesh,1.2.1 - Rape_Gang Rape,2014,8,0,14,14,14,0,0,0,0,1,0,2,6,8,0,9,13,14,8,0,0,22,0,5,0,0,0,0,5,5,17
Andhra Pradesh,1.2.2 - Rape_Others,2014,594,9,938,947,948,0,0,9,31,4,0,253,389,642,13,690,842,1640,642,0,0,2282,11,464,0,59,59,3,402,405,1807
Andhra Pradesh,2 - Attempt to commit Rape (Section 376 & 511 IPC),2014,48,2,163,165,165,0,0,0,18,1,0,69,32,101,5,125,88,111,101,0,0,212,10,69,0,6,6,3,60,63,133
Andhra Pradesh,"3 - Kidnapping & Abduction of Women (Section 363,364,364A, 366-369 IPC)",2014,439,8,713,721,806,0,0,1,155,56,0,243,221,464,21,696,463,1104,464,0,0,1568,18,334,1,11,12,19,303,322,1216
Andhra Pradesh,3.1 - Kidnaping & Abduction Section 363 IPC,2014,68,1,179,180,249,0,0,1,29,17,0,62,49,111,3,160,87,227,111,0,0,338,3,63,1,4,5,4,54,58,272
Andhra Pradesh,3.2 - Kidnaping & Abduction in order to Murder Section 364 IPC,2014,0,1,0,1,1,0,0,0,0,0,0,0,0,0,0,0,1,0,0,0,0,0,0,0,0,0,0,0,0,0,0
Andhra Pradesh,3.3 - Kidnapping for Ransom Section 364A,2014,1,1,2,3,3,0,0,0,1,0,0,0,0,0,0,1,3,0,0,0,0,0,0,0,0,0,0,0,0,0,0
Andhra Pradesh,3.4 - Kidnapping & Abduction of Women to compel her for marriage,2014,231,2,272,274,274,0,0,0,67,17,0,96,119,215,16,315,190,535,215,0,0,750,14,157,0,2,2,9,146,155,579
Andhra Pradesh,3.5 - Kidnapping & Abduction of Women-Other,2014,139,3,260,263,279,0,0,0,58,22,0,85,53,138,2,220,182,342,138,0,0,480,1,114,0,5,5,6,103,109,365
Andhra Pradesh,4 - Dowry Deaths (Section 304-B IPC),2014,160,3,212,215,215,0,0,2,5,1,0,62,124,186,0,192,181,541,186,0,0,727,1,148,2,27,29,9,110,119,578
Andhra Pradesh,5 - Assault on Women with intent to outrage her Modesty_Total (Section 354 IPC),2014,1852,153,4394,4547,4557,0,0,9,775,91,1,2106,1114,3220,90,4177,2213,5267,3220,0,0,8487,270,1794,21,145,166,213,1415,1628,6423
Andhra Pradesh,5.1 - Sexual Harassment,2014,296,7,1065,1072,1076,0,0,4,162,16,0,491,212,703,25,906,458,483,703,0,0,1186,26,264,4,17,21,21,222,243,896
Andhra Pradesh,5.2 - Assault on women with intent to Disrobe,2014,29,9,325,334,335,0,0,0,53,6,0,140,20,160,11,230,133,47,160,0,0,207,5,15,1,0,1,4,10,14,187
Andhra Pradesh,5.3 - Voyeurism,2014,11,0,71,71,71,0,0,0,4,0,0,42,2,44,2,50,32,4,44,0,0,48,0,3,0,0,0,3,0,3,45
Andhra Pradesh,5.4 - Stalking,2014,60,2,502,504,504,0,0,1,24,1,0,267,49,316,13,354,209,39,316,0,0,355,13,14,1,0,1,5,8,13,328
Andhra Pradesh,5.5 - Others,2014,1456,135,2431,2566,2571,0,0,4,532,68,1,1166,831,1997,39,2637,1381,4694,1997,0,0,6691,226,1498,15,128,143,180,1175,1355,4967
Andhra Pradesh,6 - Insult to the Modesty of Women_Total (Section 509 IPC),2014,633,39,2610,2649,2676,0,0,6,320,32,8,1379,758,2137,25,2522,754,3527,2137,0,7,5657,1105,1534,67,221,288,400,846,1246,3018
Andhra Pradesh,6.1 - At Office premises,2014,8,0,3,3,3,0,0,0,1,0,0,2,0,2,0,3,8,12,2,0,0,14,2,4,0,0,0,0,4,4,8
Andhra Pradesh,6.2 - Other places related to work,2014,40,0,84,84,84,0,0,1,11,0,0,21,75,96,0,107,16,166,96,0,0,262,57,78,0,0,0,6,72,78,127
Andhra Pradesh,6.3 - In Public Transport system,2014,8,2,63,65,65,0,0,1,4,0,0,9,40,49,10,63,9,41,49,0,0,90,6,23,2,5,7,4,12,16,61
Andhra Pradesh,6.4 - in Other Places,2014,577,37,2460,2497,2524,0,0,4,304,32,8,1347,643,1990,15,2349,721,3308,1990,0,7,5291,1040,1429,65,216,281,390,758,1148,2822
Andhra Pradesh,7 - Cruelty by Husband or his Relatives (Section 498A),2014,3374,593,5769,6362,6401,0,0,53,367,112,1,3436,2210,5646,91,6217,3466,15017,5646,0,1,20662,1879,3403,47,181,228,345,2830,3175,15380
Andhra Pradesh,8 - Importation of Girls from Foreign Country (Section 366B IPC),2014,0,0,0,0,0,0,0,0,0,0,0,0,0,0,0,0,0,0,0,0,0,0,0,0,0,0,0,0,0,0,0
Andhra Pradesh,9 - Abetment of Suicides of Women u/s 306 IPC,2014,142,0,217,217,217,0,0,4,3,2,0,84,93,177,5,187,168,363,177,0,0,540,4,115,1,10,11,5,99,104,421
Andhra Pradesh,"10 - Dowry Prohibition Act, 1961",2014,531,7,461,468,468,0,0,0,51,0,0,240,329,569,3,623,376,1934,569,0,0,2503,165,804,0,26,26,35,743,778,1534
Andhra Pradesh,"11 - Indecent Representation of Women (Prohibition) Act, 1986",2014,14,0,3,3,3,0,0,0,0,0,0,2,12,14,0,14,3,33,14,0,0,47,0,21,0,4,4,0,17,17,26
Andhra Pradesh,12 - Commission of Sati Prevention Act 1987,2014,0,0,0,0,0,0,0,0,0,0,0,0,0,0,0,0,0,0,0,0,0,0,0,0,0,0,0,0,0,0,0
Andhra Pradesh,"13 - Protection of Women from Domestic Violence Act, 2005",2014,0,0,0,0,0,0,0,0,0,0,0,0,0,0,0,0,0,0,0,0,0,0,0,0,0,0,0,0,0,0,0
Andhra Pradesh,14 - Immoral Traffic (Prevention) Act (Women Cases only),2014,97,0,204,204,289,0,0,0,0,1,0,155,70,225,0,226,75,349,225,0,0,574,1,110,0,6,6,4,100,104,463
Andhra Pradesh,14.1 - Under ITP Section 5,2014,21,0,23,23,29,0,0,0,0,0,0,11,13,24,0,24,20,48,24,0,0,72,1,18,0,2,2,1,15,16,53
Andhra Pradesh,14.2 - Under ITP Section 6,2014,0,0,0,0,0,0,0,0,0,0,0,0,0,0,0,0,0,0,0,0,0,0,0,0,0,0,0,0,0,0,0
Andhra Pradesh,14.3 - Under ITP Section 7,2014,0,0,0,0,0,0,0,0,0,0,0,0,0,0,0,0,0,0,0,0,0,0,0,0,0,0,0,0,0,0,0
Andhra Pradesh,14.4 - Under ITP Section 8,2014,0,0,2,2,2,0,0,0,0,0,0,2,0,2,0,2,0,0,2,0,0,2,0,0,0,0,0,0,0,0,2
Andhra Pradesh,14.5 - Other Sections under ITP Act,2014,76,0,179,179,258,0,0,0,0,1,0,142,57,199,0,200,55,301,199,0,0,500,0,92,0,4,4,3,85,88,408
Andhra Pradesh,15 - Total Crimes against Women,2014,7892,814,15698,16512,16759,0,0,84,1725,301,10,8031,5358,13389,253,15678,8642,29900,13389,0,8,43281,3464,8801,139,696,835,1036,6930,7966,31016
Arunachal Pradesh,1 - Rape (Section 376 IPC),2014,51,0,83,83,83,0,0,1,0,0,0,50,24,74,7,81,52,577,74,0,0,651,0,7,0,3,3,0,4,4,644
Arunachal Pradesh,1.1 - Custodial Rape,2014,0,0,4,4,4,0,0,0,0,0,0,0,0,0,0,0,4,0,0,0,0,0,0,0,0,0,0,0,0,0,0
Arunachal Pradesh,1.1.1 - Custodial_Gang Rape,2014,0,0,0,0,0,0,0,0,0,0,0,0,0,0,0,0,0,0,0,0,0,0,0,0,0,0,0,0,0,0,0
Arunachal Pradesh,1.1.2 - Custodial_Other Rape,2014,0,0,4,4,4,0,0,0,0,0,0,0,0,0,0,0,4,0,0,0,0,0,0,0,0,0,0,0,0,0,0
Arunachal Pradesh,1.2 - Rape other than Custodial,2014,51,0,79,79,79,0,0,1,0,0,0,50,24,74,7,81,48,577,74,0,0,651,0,7,0,3,3,0,4,4,644
Arunachal Pradesh,1.2.1 - Rape_Gang Rape,2014,1,0,5,5,5,0,0,1,0,0,0,3,0,3,0,3,2,0,3,0,0,3,0,0,0,0,0,0,0,0,3
Arunachal Pradesh,1.2.2 - Rape_Others,2014,50,0,74,74,74,0,0,0,0,0,0,47,24,71,7,78,46,577,71,0,0,648,0,7,0,3,3,0,4,4,641
Arunachal Pradesh,2 - Attempt to commit Rape (Section 376 & 511 IPC),2014,0,0,10,10,10,0,0,0,0,0,0,6,0,6,0,6,4,0,6,0,0,6,0,1,1,0,1,0,0,0,5
Arunachal Pradesh,"3 - Kidnapping & Abduction of Women (Section 363,364,364A, 366-369 IPC)",2014,26,0,91,91,107,0,0,0,0,0,0,30,9,39,39,78,39,169,39,0,0,208,1,0,0,0,0,0,0,0,207
Arunachal Pradesh,3.1 - Kidnaping & Abduction Section 363 IPC,2014,0,0,25,25,27,0,0,0,0,0,0,3,0,3,16,19,6,0,3,0,0,3,0,0,0,0,0,0,0,0,3
Arunachal Pradesh,3.2 - Kidnaping & Abduction in order to Murder Section 364 IPC,2014,0,0,1,1,1,0,0,0,0,0,0,1,0,1,0,1,0,0,1,0,0,1,0,0,0,0,0,0,0,0,1
Arunachal Pradesh,3.3 - Kidnapping for Ransom Section 364A,2014,0,0,1,1,1,0,0,0,0,0,0,0,0,0,0,0,1,0,0,0,0,0,0,0,0,0,0,0,0,0,0
Arunachal Pradesh,3.4 - Kidnapping & Abduction of Women to compel her for marriage,2014,5,0,20,20,20,0,0,0,0,0,0,8,0,8,8,16,9,162,8,0,0,170,1,0,0,0,0,0,0,0,169
Arunachal Pradesh,3.5 - Kidnapping & Abduction of Women-Other,2014,21,0,44,44,58,0,0,0,0,0,0,18,9,27,15,42,23,7,27,0,0,34,0,0,0,0,0,0,0,0,34
Arunachal Pradesh,4 - Dowry Deaths (Section 304-B IPC),2014,0,0,1,1,1,0,0,0,0,0,0,0,0,0,0,0,1,1,0,0,0,1,0,0,0,0,0,0,0,0,1
Arunachal Pradesh,5 - Assault on Women with intent to outrage her Modesty_Total (Section 354 IPC),2014,66,0,121,121,130,0,0,0,0,0,0,70,21,91,10,101,86,466,91,0,0,557,2,6,1,4,5,0,1,1,549
Arunachal Pradesh,5.1 - Sexual Harassment,2014,0,0,21,21,21,0,0,0,0,0,0,16,0,16,0,16,5,0,16,0,0,16,0,2,1,0,1,0,1,1,14
Arunachal Pradesh,5.2 - Assault on women with intent to Disrobe,2014,0,0,0,0,0,0,0,0,0,0,0,0,0,0,0,0,0,0,0,0,0,0,0,0,0,0,0,0,0,0,0
Arunachal Pradesh,5.3 - Voyeurism,2014,0,0,6,6,6,0,0,0,0,0,0,4,0,4,1,5,1,0,4,0,0,4,0,0,0,0,0,0,0,0,4
Arunachal Pradesh,5.4 - Stalking,2014,0,0,1,1,1,0,0,0,0,0,0,1,0,1,0,1,0,0,1,0,0,1,0,0,0,0,0,0,0,0,1
Arunachal Pradesh,5.5 - Others,2014,66,0,93,93,102,0,0,0,0,0,0,49,21,70,9,79,80,466,70,0,0,536,2,4,0,4,4,0,0,0,530
Arunachal Pradesh,6 - Insult to the Modesty of Women_Total (Section 509 IPC),2014,0,0,3,3,3,0,0,0,0,0,0,1,0,1,0,1,2,25,1,0,0,26,0,0,0,0,0,0,0,0,26
Arunachal Pradesh,6.1 - At Office premises,2014,0,0,0,0,0,0,0,0,0,0,0,0,0,0,0,0,0,0,0,0,0,0,0,0,0,0,0,0,0,0,0
Arunachal Pradesh,6.2 - Other places related to work,2014,0,0,0,0,0,0,0,0,0,0,0,0,0,0,0,0,0,0,0,0,0,0,0,0,0,0,0,0,0,0,0
Arunachal Pradesh,6.3 - In Public Transport system,2014,0,0,0,0,0,0,0,0,0,0,0,0,0,0,0,0,0,0,0,0,0,0,0,0,0,0,0,0,0,0,0
Arunachal Pradesh,6.4 - in Other Places,2014,0,0,3,3,3,0,0,0,0,0,0,1,0,1,0,1,2,25,1,0,0,26,0,0,0,0,0,0,0,0,26
Arunachal Pradesh,7 - Cruelty by Husband or his Relatives (Section 498A),2014,19,0,42,42,42,0,0,1,0,0,0,23,7,30,1,31,29,118,30,0,0,148,0,0,0,0,0,0,0,0,148
Arunachal Pradesh,8 - Importation of Girls from Foreign Country (Section 366B IPC),2014,0,0,0,0,0,0,0,0,0,0,0,0,0,0,0,0,0,0,0,0,0,0,0,0,0,0,0,0,0,0,0
Arunachal Pradesh,9 - Abetment of Suicides of Women u/s 306 IPC,2014,0,0,0,0,0,0,0,0,0,0,0,0,0,0,0,0,0,0,0,0,0,0,0,0,0,0,0,0,0,0,0
Arunachal Pradesh,"10 - Dowry Prohibition Act, 1961",2014,0,0,0,0,0,0,0,0,0,0,0,0,0,0,0,0,0,0,0,0,0,0,0,0,0,0,0,0,0,0,0
Arunachal Pradesh,"11 - Indecent Representation of Women (Prohibition) Act, 1986",2014,0,0,0,0,0,0,0,0,0,0,0,0,0,0,0,0,0,0,0,0,0,0,0,0,0,0,0,0,0,0,0
Arunachal Pradesh,12 - Commission of Sati Prevention Act 1987,2014,0,0,0,0,0,0,0,0,0,0,0,0,0,0,0,0,0,0,0,0,0,0,0,0,0,0,0,0,0,0,0
Arunachal Pradesh,"13 - Protection of Women from Domestic Violence Act, 2005",2014,0,0,0,0,0,0,0,0,0,0,0,0,0,0,0,0,0,0,0,0,0,0,0,0,0,0,0,0,0,0,0
Arunachal Pradesh,14 - Immoral Traffic (Prevention) Act (Women Cases only),2014,0,0,0,0,0,0,0,0,0,0,0,0,0,0,0,0,0,0,0,0,0,0,0,0,0,0,0,0,0,0,0
Arunachal Pradesh,14.1 - Under ITP Section 5,2014,0,0,0,0,0,0,0,0,0,0,0,0,0,0,0,0,0,0,0,0,0,0,0,0,0,0,0,0,0,0,0
Arunachal Pradesh,14.2 - Under ITP Section 6,2014,0,0,0,0,0,0,0,0,0,0,0,0,0,0,0,0,0,0,0,0,0,0,0,0,0,0,0,0,0,0,0
Arunachal Pradesh,14.3 - Under ITP Section 7,2014,0,0,0,0,0,0,0,0,0,0,0,0,0,0,0,0,0,0,0,0,0,0,0,0,0,0,0,0,0,0,0
Arunachal Pradesh,14.4 - Under ITP Section 8,2014,0,0,0,0,0,0,0,0,0,0,0,0,0,0,0,0,0,0,0,0,0,0,0,0,0,0,0,0,0,0,0
Arunachal Pradesh,14.5 - Other Sections under ITP Act,2014,0,0,0,0,0,0,0,0,0,0,0,0,0,0,0,0,0,0,0,0,0,0,0,0,0,0,0,0,0,0,0
Arunachal Pradesh,15 - Total Crimes against Women,2014,162,0,351,351,376,0,0,2,0,0,0,180,61,241,57,298,213,1356,241,0,0,1597,3,14,2,7,9,0,5,5,1580
Assam,1 - Rape (Section 376 IPC),2014,3277,45,1935,1980,2047,0,0,0,38,24,0,708,660,1368,651,2081,3176,6078,1368,0,0,7446,0,829,69,101,170,179,480,659,6617
Assam,1.1 - Custodial Rape,2014,0,0,0,0,0,0,0,0,0,0,0,0,0,0,0,0,0,0,0,0,0,0,0,0,0,0,0,0,0,0,0
Assam,1.1.1 - Custodial_Gang Rape,2014,0,0,0,0,0,0,0,0,0,0,0,0,0,0,0,0,0,0,0,0,0,0,0,0,0,0,0,0,0,0,0
Assam,1.1.2 - Custodial_Other Rape,2014,0,0,0,0,0,0,0,0,0,0,0,0,0,0,0,0,0,0,0,0,0,0,0,0,0,0,0,0,0,0,0
Assam,1.2 - Rape other than Custodial,2014,3277,45,1935,1980,2047,0,0,0,38,24,0,708,660,1368,651,2081,3176,6078,1368,0,0,7446,0,829,69,101,170,179,480,659,6617
Assam,1.2.1 - Rape_Gang Rape,2014,0,0,23,23,23,0,0,0,2,0,0,9,0,9,5,16,7,0,9,0,0,9,0,3,3,0,3,0,0,0,6
Assam,1.2.2 - Rape_Others,2014,3277,45,1912,1957,2024,0,0,0,36,24,0,699,660,1359,646,2065,3169,6078,1359,0,0,7437,0,826,66,101,167,179,480,659,6611
Assam,2 - Attempt to commit Rape (Section 376 & 511 IPC),2014,0,15,212,227,227,0,0,0,3,2,0,77,0,77,35,117,110,0,77,0,0,77,0,29,16,1,17,12,0,12,48
Assam,"3 - Kidnapping & Abduction of Women (Section 363,364,364A, 366-369 IPC)",2014,5752,72,3823,3895,3895,11,0,0,98,140,0,732,619,1351,1660,3249,6387,4608,1351,0,0,5959,0,723,44,49,93,260,370,630,5236
Assam,3.1 - Kidnaping & Abduction Section 363 IPC,2014,0,0,0,0,0,0,0,0,0,0,0,0,0,0,0,0,0,0,0,0,0,0,0,0,0,0,0,0,0,0,0
Assam,3.2 - Kidnaping & Abduction in order to Murder Section 364 IPC,2014,0,0,1,1,1,0,0,0,0,0,0,0,0,0,0,0,1,0,0,0,0,0,0,0,0,0,0,0,0,0,0
Assam,3.3 - Kidnapping for Ransom Section 364A,2014,0,0,3,3,3,0,0,0,0,0,0,0,0,0,0,0,3,0,0,0,0,0,0,0,0,0,0,0,0,0,0
Assam,3.4 - Kidnapping & Abduction of Women to compel her for marriage,2014,5752,72,3811,3883,3883,11,0,0,98,140,0,730,618,1348,1658,3244,6380,4607,1348,0,0,5955,0,722,44,49,93,259,370,629,5233
Assam,3.5 - Kidnapping & Abduction of Women-Other,2014,0,0,8,8,8,0,0,0,0,0,0,2,1,3,2,5,3,1,3,0,0,4,0,1,0,0,0,1,0,1,3
Assam,4 - Dowry Deaths (Section 304-B IPC),2014,316,2,186,188,189,0,0,0,0,3,0,69,42,111,18,132,372,500,111,1,0,610,0,63,3,15,18,8,37,45,547
Assam,5 - Assault on Women with intent to outrage her Modesty_Total (Section 354 IPC),2014,1784,172,2927,3099,3100,0,0,0,45,129,1,699,417,1116,1283,2574,2309,2707,1116,0,0,3823,0,776,27,30,57,300,419,719,3047
Assam,5.1 - Sexual Harassment,2014,0,32,426,458,458,0,0,0,5,5,0,85,0,85,160,255,203,2,85,0,0,87,0,30,4,0,4,24,2,26,57
Assam,5.2 - Assault on women with intent to Disrobe,2014,227,1,398,399,399,0,0,0,0,0,0,57,34,91,226,317,309,212,91,0,0,303,0,8,0,2,2,3,3,6,295
Assam,5.3 - Voyeurism,2014,0,0,0,0,0,0,0,0,0,0,0,0,0,0,0,0,0,0,0,0,0,0,0,0,0,0,0,0,0,0,0
Assam,5.4 - Stalking,2014,0,0,0,0,0,0,0,0,0,0,0,0,0,0,0,0,0,0,0,0,0,0,0,0,0,0,0,0,0,0,0
Assam,5.5 - Others,2014,1557,139,2103,2242,2243,0,0,0,40,124,1,557,383,940,897,2002,1797,2493,940,0,0,3433,0,738,23,28,51,273,414,687,2695
Assam,6 - Insult to the Modesty of Women_Total (Section 509 IPC),2014,0,0,1,1,1,0,0,0,0,0,0,1,0,1,0,1,0,0,1,0,0,1,0,1,0,0,0,0,1,1,0
Assam,6.1 - At Office premises,2014,0,0,0,0,0,0,0,0,0,0,0,0,0,0,0,0,0,0,0,0,0,0,0,0,0,0,0,0,0,0,0
Assam,6.2 - Other places related to work,2014,0,0,1,1,1,0,0,0,0,0,0,1,0,1,0,1,0,0,1,0,0,1,0,1,0,0,0,0,1,1,0
Assam,6.3 - In Public Transport system,2014,0,0,0,0,0,0,0,0,0,0,0,0,0,0,0,0,0,0,0,0,0,0,0,0,0,0,0,0,0,0,0
Assam,6.4 - in Other Places,2014,0,0,0,0,0,0,0,0,0,0,0,0,0,0,0,0,0,0,0,0,0,0,0,0,0,0,0,0,0,0,0
Assam,7 - Cruelty by Husband or his Relatives (Section 498A),2014,6786,655,8971,9626,9626,0,0,36,168,813,4,3497,2449,5946,2282,9213,7163,11135,5946,0,12,17069,114,3285,70,89,159,1244,1882,3126,13670
Assam,8 - Importation of Girls from Foreign Country (Section 366B IPC),2014,4,0,1,1,1,0,0,0,0,0,0,1,0,1,0,1,4,1,1,0,0,2,0,0,0,0,0,0,0,0,2
Assam,9 - Abetment of Suicides of Women u/s 306 IPC,2014,0,0,0,0,0,0,0,0,0,0,0,0,0,0,0,0,0,0,0,0,0,0,0,0,0,0,0,0,0,0,0
Assam,"10 - Dowry Prohibition Act, 1961",2014,37,2,90,92,92,0,0,0,0,0,0,46,4,50,30,80,49,222,50,0,0,272,0,6,0,2,2,4,0,4,266
Assam,"11 - Indecent Representation of Women (Prohibition) Act, 1986",2014,2,0,0,0,0,0,0,0,0,0,0,0,0,0,0,0,2,0,0,0,0,0,0,0,0,0,0,0,0,0,0
Assam,12 - Commission of Sati Prevention Act 1987,2014,0,0,0,0,0,0,0,0,0,0,0,0,0,0,0,0,0,0,0,0,0,0,0,0,0,0,0,0,0,0,0
Assam,"13 - Protection of Women from Domestic Violence Act, 2005",2014,0,0,1,1,1,0,0,0,0,0,0,1,0,1,0,1,0,0,1,0,0,1,0,0,0,0,0,0,0,0,1
Assam,14 - Immoral Traffic (Prevention) Act (Women Cases only),2014,22,0,29,29,29,0,0,0,0,0,0,10,3,13,2,15,36,24,13,0,0,37,0,7,0,0,0,3,4,7,30
Assam,14.1 - Under ITP Section 5,2014,0,0,6,6,6,0,0,0,0,0,0,0,0,0,0,0,6,0,0,0,0,0,0,0,0,0,0,0,0,0,0
Assam,14.2 - Under ITP Section 6,2014,2,0,1,1,1,0,0,0,0,0,0,0,2,2,0,2,1,4,2,0,0,6,0,4,0,0,0,0,4,4,2
Assam,14.3 - Under ITP Section 7,2014,0,0,2,2,2,0,0,0,0,0,0,0,0,0,0,0,2,0,0,0,0,0,0,0,0,0,0,0,0,0,0
Assam,14.4 - Under ITP Section 8,2014,0,0,0,0,0,0,0,0,0,0,0,0,0,0,0,0,0,0,0,0,0,0,0,0,0,0,0,0,0,0,0
Assam,14.5 - Other Sections under ITP Act,2014,20,0,20,20,20,0,0,0,0,0,0,10,1,11,2,13,27,20,11,0,0,31,0,3,0,0,0,3,0,3,28
Assam,15 - Total Crimes against Women,2014,17980,963,18176,19139,19208,11,0,36,352,1111,5,5841,4194,10035,5961,17464,19608,25275,10035,1,12,35297,114,5719,229,287,516,2010,3193,5203,29464
Bihar,1 - Rape (Section 376 IPC),2014,832,142,985,1127,1169,0,0,0,92,34,3,536,312,848,57,1034,925,3820,848,0,0,4668,27,432,31,85,116,64,252,316,4209
Bihar,1.1 - Custodial Rape,2014,0,0,0,0,0,0,0,0,0,0,0,0,0,0,0,0,0,1,0,0,0,1,0,1,0,1,1,0,0,0,0
Bihar,1.1.1 - Custodial_Gang Rape,2014,0,0,0,0,0,0,0,0,0,0,0,0,0,0,0,0,0,0,0,0,0,0,0,0,0,0,0,0,0,0,0
Bihar,1.1.2 - Custodial_Other Rape,2014,0,0,0,0,0,0,0,0,0,0,0,0,0,0,0,0,0,1,0,0,0,1,0,1,0,1,1,0,0,0,0
Bihar,1.2 - Rape other than Custodial,2014,832,142,985,1127,1169,0,0,0,87,34,8,536,312,848,57,1034,925,3819,848,0,0,4667,27,431,31,84,115,64,252,316,4209
Bihar,1.2.1 - Rape_Gang Rape,2014,0,1,23,24,27,0,0,0,0,0,0,16,0,16,0,16,8,0,16,0,0,16,0,3,2,1,3,0,0,0,13
Bihar,1.2.2 - Rape_Others,2014,832,141,962,1103,1142,0,0,0,92,34,3,520,312,832,57,1018,917,3819,832,0,0,4651,27,428,29,83,112,64,252,316,4196
Bihar,2 - Attempt to commit Rape (Section 376 & 511 IPC),2014,0,84,400,484,484,0,0,0,77,15,9,193,2,195,3,299,185,0,195,0,0,195,3,40,10,3,13,24,3,27,152
Bihar,"3 - Kidnapping & Abduction of Women (Section 363,364,364A, 366-369 IPC)",2014,2163,238,4497,4735,4760,0,0,0,72,681,15,1231,1041,2272,616,3656,3242,7866,2272,0,0,10138,141,850,19,62,81,146,623,769,9147
Bihar,3.1 - Kidnaping & Abduction Section 363 IPC,2014,0,0,55,55,55,0,0,0,3,4,2,11,0,11,7,27,28,0,11,0,0,11,0,1,0,0,0,1,0,1,10
Bihar,3.2 - Kidnaping & Abduction in order to Murder Section 364 IPC,2014,0,0,9,9,9,0,0,0,0,0,0,2,0,2,0,2,7,0,2,0,0,2,0,1,0,0,0,1,0,1,1
Bihar,3.3 - Kidnapping for Ransom Section 364A,2014,0,0,2,2,2,0,0,0,0,0,0,0,0,0,0,0,2,0,0,0,0,0,0,0,0,0,0,0,0,0,0
Bihar,3.4 - Kidnapping & Abduction of Women to compel her for marriage,2014,2163,235,4406,4641,4641,0,0,0,68,677,13,1207,1041,2248,609,3615,3189,7866,2248,0,0,10114,141,848,19,62,81,144,623,767,9125
Bihar,3.5 - Kidnapping & Abduction of Women-Other,2014,0,3,25,28,53,0,0,0,1,0,0,11,0,11,0,12,16,0,11,0,0,11,0,0,0,0,0,0,0,0,11
Bihar,4 - Dowry Deaths (Section 304-B IPC),2014,1541,140,1233,1373,1394,0,0,1,9,88,41,516,563,1079,104,1321,1592,5713,1079,0,9,6783,130,507,28,107,135,50,322,372,6146
Bihar,5 - Assault on Women with intent to outrage her Modesty_Total (Section 354 IPC),2014,109,50,522,572,574,0,0,0,52,29,21,343,46,389,24,515,166,120,389,0,0,509,1,55,4,8,12,21,22,43,453
Bihar,5.1 - Sexual Harassment,2014,57,23,248,271,271,0,0,0,20,14,9,179,25,204,11,258,70,78,204,0,0,282,1,25,1,3,4,10,11,21,256
Bihar,5.2 - Assault on women with intent to Disrobe,2014,2,3,58,61,63,0,0,0,1,0,0,47,2,49,1,51,12,2,49,0,0,51,0,5,1,0,1,4,0,4,46
Bihar,5.3 - Voyeurism,2014,0,0,4,4,4,0,0,0,0,0,0,4,0,4,0,4,0,0,4,0,0,4,0,0,0,0,0,0,0,0,4
Bihar,5.4 - Stalking,2014,0,0,7,7,7,0,0,0,0,0,0,6,0,6,0,6,1,0,6,0,0,6,0,0,0,0,0,0,0,0,6
Bihar,5.5 - Others,2014,50,24,205,229,229,0,0,0,31,15,12,107,19,126,12,196,83,40,126,0,0,166,0,25,2,5,7,7,11,18,141
Bihar,6 - Insult to the Modesty of Women_Total (Section 509 IPC),2014,95,8,61,69,69,0,0,0,1,0,1,25,82,107,8,117,47,2113,107,0,0,2220,12,197,0,11,11,18,168,186,2011
Bihar,6.1 - At Office premises,2014,0,0,0,0,0,0,0,0,0,0,0,0,0,0,0,0,0,0,0,0,0,0,0,0,0,0,0,0,0,0,0
Bihar,6.2 - Other places related to work,2014,0,0,0,0,0,0,0,0,0,0,0,0,0,0,0,0,0,0,0,0,0,0,0,0,0,0,0,0,0,0,0
Bihar,6.3 - In Public Transport system,2014,1,0,0,0,0,0,0,0,0,0,0,0,0,0,0,0,1,168,0,0,0,168,0,0,0,0,0,0,0,0,168
Bihar,6.4 - in Other Places,2014,94,8,61,69,69,0,0,0,1,0,1,25,82,107,8,117,46,1945,107,0,0,2052,12,197,0,11,11,18,168,186,1843
Bihar,7 - Cruelty by Husband or his Relatives (Section 498A),2014,2411,662,4010,4672,4768,0,0,0,184,171,36,1950,1293,3243,687,4321,2762,9994,3243,0,11,13226,366,1281,20,89,109,168,1004,1172,11579
Bihar,8 - Importation of Girls from Foreign Country (Section 366B IPC),2014,37,0,5,5,5,0,0,0,0,7,3,5,6,11,4,25,17,114,11,0,0,125,0,12,1,2,3,0,9,9,113
Bihar,9 - Abetment of Suicides of Women u/s 306 IPC,2014,0,0,0,0,0,0,0,0,0,0,0,0,0,0,0,0,0,0,0,0,0,0,0,0,0,0,0,0,0,0,0
Bihar,"10 - Dowry Prohibition Act, 1961",2014,1259,328,1875,2203,2262,0,0,0,101,93,9,1330,579,1909,162,2274,1188,5702,1909,0,5,7606,133,563,12,31,43,189,331,520,6910
Bihar,"11 - Indecent Representation of Women (Prohibition) Act, 1986",2014,0,0,0,0,0,0,0,0,0,0,0,0,0,0,0,0,0,42,0,0,0,42,0,0,0,0,0,0,0,0,42
Bihar,12 - Commission of Sati Prevention Act 1987,2014,0,0,0,0,0,0,0,0,0,0,0,0,0,0,0,0,0,0,0,0,0,0,0,0,0,0,0,0,0,0,0
Bihar,"13 - Protection of Women from Domestic Violence Act, 2005",2014,0,0,112,112,112,0,0,0,4,0,5,52,0,52,0,61,51,0,52,0,0,52,0,5,2,0,2,3,0,3,47
Bihar,14 - Immoral Traffic (Prevention) Act (Women Cases only),2014,1,0,31,31,33,0,0,0,0,0,0,25,1,26,3,29,3,16,26,0,0,42,0,2,0,0,0,0,2,2,40
Bihar,14.1 - Under ITP Section 5,2014,1,0,29,29,30,0,0,0,0,0,0,24,1,25,3,28,2,16,25,0,0,41,0,1,0,0,0,0,1,1,40
Bihar,14.2 - Under ITP Section 6,2014,0,0,2,2,3,0,0,0,0,0,0,1,0,1,0,1,1,0,1,0,0,1,0,1,0,0,0,0,1,1,0
Bihar,14.3 - Under ITP Section 7,2014,0,0,0,0,0,0,0,0,0,0,0,0,0,0,0,0,0,0,0,0,0,0,0,0,0,0,0,0,0,0,0
Bihar,14.4 - Under ITP Section 8,2014,0,0,0,0,0,0,0,0,0,0,0,0,0,0,0,0,0,0,0,0,0,0,0,0,0,0,0,0,0,0,0
Bihar,14.5 - Other Sections under ITP Act,2014,0,0,0,0,0,0,0,0,0,0,0,0,0,0,0,0,0,0,0,0,0,0,0,0,0,0,0,0,0,0,0
Bihar,15 - Total Crimes against Women,2014,8448,1652,13731,15383,15630,0,0,1,592,1118,143,6206,3925,10131,1668,13652,10178,35500,10131,0,25,45606,813,3944,127,398,525,683,2736,3419,40849
Chhattisgarh,1 - Rape (Section 376 IPC),2014,161,0,1436,1436,1436,0,0,1,6,1,0,1297,132,1429,13,1449,147,2797,1429,0,0,4226,3,1225,94,210,304,292,629,921,2998
Chhattisgarh,1.1 - Custodial Rape,2014,0,0,0,0,0,0,0,0,0,0,0,0,0,0,0,0,0,0,0,0,0,0,0,0,0,0,0,0,0,0,0
Chhattisgarh,1.1.1 - Custodial_Gang Rape,2014,0,0,0,0,0,0,0,0,0,0,0,0,0,0,0,0,0,0,0,0,0,0,0,0,0,0,0,0,0,0,0
Chhattisgarh,1.1.2 - Custodial_Other Rape,2014,0,0,0,0,0,0,0,0,0,0,0,0,0,0,0,0,0,0,0,0,0,0,0,0,0,0,0,0,0,0,0
Chhattisgarh,1.2 - Rape other than Custodial,2014,161,0,1436,1436,1436,0,0,1,6,1,0,1297,132,1429,13,1449,147,2797,1429,0,0,4226,3,1225,94,210,304,292,629,921,2998
Chhattisgarh,1.2.1 - Rape_Gang Rape,2014,5,0,64,64,64,0,0,0,0,0,0,54,5,59,2,61,8,59,59,0,0,118,0,20,4,2,6,5,9,14,98
Chhattisgarh,1.2.2 - Rape_Others,2014,156,0,1372,1372,1372,0,0,1,6,1,0,1243,127,1370,11,1388,139,2738,1370,0,0,4108,3,1205,90,208,298,287,620,907,2900
Chhattisgarh,2 - Attempt to commit Rape (Section 376 & 511 IPC),2014,0,0,21,21,21,0,0,0,0,0,0,20,0,20,0,20,1,5,20,0,0,25,0,6,2,1,3,1,2,3,19
Chhattisgarh,"3 - Kidnapping & Abduction of Women (Section 363,364,364A, 366-369 IPC)",2014,771,0,1393,1393,1449,0,0,0,321,119,0,518,248,766,244,1450,714,654,766,8,0,1412,0,274,38,47,85,67,122,189,1138
Chhattisgarh,3.1 - Kidnaping & Abduction Section 363 IPC,2014,589,0,922,922,944,0,0,0,291,88,0,245,156,401,190,970,541,494,401,0,0,895,0,175,15,37,52,36,87,123,720
Chhattisgarh,3.2 - Kidnaping & Abduction in order to Murder Section 364 IPC,2014,0,0,5,5,5,0,0,0,0,0,0,2,0,2,0,2,3,0,2,0,0,2,0,0,0,0,0,0,0,0,2
Chhattisgarh,3.3 - Kidnapping for Ransom Section 364A,2014,0,0,0,0,0,0,0,0,0,0,0,0,0,0,0,0,0,0,0,0,0,0,0,0,0,0,0,0,0,0,0
Chhattisgarh,3.4 - Kidnapping & Abduction of Women to compel her for marriage,2014,129,0,263,263,274,0,0,0,18,29,0,169,50,219,32,298,94,76,219,0,0,295,0,53,12,5,17,16,20,36,242
Chhattisgarh,3.5 - Kidnapping & Abduction of Women-Other,2014,53,0,203,203,226,0,0,0,12,2,0,102,42,144,22,180,76,84,144,8,0,220,0,46,11,5,16,15,15,30,174
Chhattisgarh,4 - Dowry Deaths (Section 304-B IPC),2014,13,0,128,128,129,0,0,0,0,0,0,112,12,124,1,125,16,388,124,0,0,512,0,96,13,29,42,13,41,54,416
Chhattisgarh,5 - Assault on Women with intent to outrage her Modesty_Total (Section 354 IPC),2014,133,0,2122,2122,2130,0,0,0,4,3,0,1977,134,2111,19,2137,118,7481,2111,0,1,9591,52,1816,165,647,812,305,699,1004,7723
Chhattisgarh,5.1 - Sexual Harassment,2014,46,0,649,649,649,0,0,0,1,0,0,587,52,639,7,647,48,1281,639,0,1,1919,39,519,61,124,185,124,210,334,1361
Chhattisgarh,5.2 - Assault on women with intent to Disrobe,2014,3,0,76,76,76,0,0,0,0,0,0,72,3,75,1,76,3,17,75,0,0,92,0,13,4,3,7,2,4,6,79
Chhattisgarh,5.3 - Voyeurism,2014,1,0,9,9,9,0,0,0,0,0,0,9,1,10,0,10,0,8,10,0,0,18,0,8,1,3,4,1,3,4,10
Chhattisgarh,5.4 - Stalking,2014,1,0,72,72,72,0,0,0,0,0,0,69,0,69,0,69,4,3,69,0,0,72,0,11,3,1,4,4,3,7,61
Chhattisgarh,5.5 - Others,2014,82,0,1316,1316,1324,0,0,0,3,3,0,1240,78,1318,11,1335,63,6172,1318,0,0,7490,13,1265,96,516,612,174,479,653,6212
Chhattisgarh,6 - Insult to the Modesty of Women_Total (Section 509 IPC),2014,9,0,79,79,79,0,0,0,0,0,0,67,7,74,5,79,9,566,74,0,4,636,7,112,5,46,51,10,51,61,517
Chhattisgarh,6.1 - At Office premises,2014,0,0,0,0,0,0,0,0,0,0,0,0,0,0,0,0,0,0,0,0,0,0,0,0,0,0,0,0,0,0,0
Chhattisgarh,6.2 - Other places related to work,2014,2,0,13,13,13,0,0,0,0,0,0,9,2,11,0,11,4,188,11,0,0,199,5,13,0,7,7,1,5,6,181
Chhattisgarh,6.3 - In Public Transport system,2014,0,0,0,0,0,0,0,0,0,0,0,0,0,0,0,0,0,0,0,0,0,0,0,0,0,0,0,0,0,0,0
Chhattisgarh,6.4 - in Other Places,2014,7,0,66,66,66,0,0,0,0,0,0,58,5,63,5,68,5,378,63,0,4,437,2,99,5,39,44,9,46,55,336
Chhattisgarh,7 - Cruelty by Husband or his Relatives (Section 498A),2014,100,0,964,964,964,0,0,0,0,0,0,860,108,968,6,974,90,4376,968,1,1,5342,69,952,31,194,225,120,607,727,4321
Chhattisgarh,8 - Importation of Girls from Foreign Country (Section 366B IPC),2014,0,0,0,0,0,0,0,0,0,0,0,0,0,0,0,0,0,0,0,0,0,0,0,0,0,0,0,0,0,0,0
Chhattisgarh,9 - Abetment of Suicides of Women u/s 306 IPC,2014,1,0,102,102,103,0,0,0,0,0,0,94,1,95,0,95,8,5,95,0,0,100,0,9,4,0,4,5,0,5,91
Chhattisgarh,"10 - Dowry Prohibition Act, 1961",2014,0,0,8,8,8,0,0,0,0,0,0,7,0,7,0,7,1,25,7,0,0,32,0,4,0,2,2,0,2,2,28
Chhattisgarh,"11 - Indecent Representation of Women (Prohibition) Act, 1986",2014,0,0,0,0,0,0,0,0,0,0,0,0,0,0,0,0,0,0,0,0,0,0,0,0,0,0,0,0,0,0,0
Chhattisgarh,12 - Commission of Sati Prevention Act 1987,2014,0,0,0,0,0,0,0,0,0,0,0,0,0,0,0,0,0,0,0,0,0,0,0,0,0,0,0,0,0,0,0
Chhattisgarh,"13 - Protection of Women from Domestic Violence Act, 2005",2014,0,0,0,0,0,0,0,0,0,0,0,0,0,0,0,0,0,0,0,0,0,0,0,0,0,0,0,0,0,0,0
Chhattisgarh,14 - Immoral Traffic (Prevention) Act (Women Cases only),2014,0,0,2,2,2,0,0,0,0,0,0,2,0,2,0,2,0,15,2,0,0,17,0,0,0,0,0,0,0,0,17
Chhattisgarh,14.1 - Under ITP Section 5,2014,0,0,2,2,2,0,0,0,0,0,0,2,0,2,0,2,0,0,2,0,0,2,0,0,0,0,0,0,0,0,2
Chhattisgarh,14.2 - Under ITP Section 6,2014,0,0,0,0,0,0,0,0,0,0,0,0,0,0,0,0,0,0,0,0,0,0,0,0,0,0,0,0,0,0,0
Chhattisgarh,14.3 - Under ITP Section 7,2014,0,0,0,0,0,0,0,0,0,0,0,0,0,0,0,0,0,0,0,0,0,0,0,0,0,0,0,0,0,0,0
Chhattisgarh,14.4 - Under ITP Section 8,2014,0,0,0,0,0,0,0,0,0,0,0,0,0,0,0,0,0,0,0,0,0,0,0,0,0,0,0,0,0,0,0
Chhattisgarh,14.5 - Other Sections under ITP Act,2014,0,0,0,0,0,0,0,0,0,0,0,0,0,0,0,0,0,15,0,0,0,15,0,0,0,0,0,0,0,0,15
Chhattisgarh,15 - Total Crimes against Women,2014,1188,0,6255,6255,6321,0,0,1,331,123,0,4954,642,5596,288,6338,1104,16312,5596,9,6,21893,131,4494,352,1176,1528,813,2153,2966,17268
Goa,1 - Rape (Section 376 IPC),2014,78,0,95,95,99,0,0,0,0,4,0,45,28,73,7,84,89,163,73,0,0,236,0,14,0,4,4,0,10,10,222
Goa,1.1 - Custodial Rape,2014,0,0,0,0,0,0,0,0,0,0,0,0,0,0,0,0,0,0,0,0,0,0,0,0,0,0,0,0,0,0,0
Goa,1.1.1 - Custodial_Gang Rape,2014,0,0,0,0,0,0,0,0,0,0,0,0,0,0,0,0,0,0,0,0,0,0,0,0,0,0,0,0,0,0,0
Goa,1.1.2 - Custodial_Other Rape,2014,0,0,0,0,0,0,0,0,0,0,0,0,0,0,0,0,0,0,0,0,0,0,0,0,0,0,0,0,0,0,0
Goa,1.2 - Rape other than Custodial,2014,78,0,95,95,99,0,0,0,0,4,0,45,28,73,7,84,89,163,73,0,0,236,0,14,0,4,4,0,10,10,222
Goa,1.2.1 - Rape_Gang Rape,2014,1,0,2,2,2,0,0,0,0,0,0,1,1,2,0,2,1,1,2,0,0,3,0,0,0,0,0,0,0,0,3
Goa,1.2.2 - Rape_Others,2014,77,0,93,93,97,0,0,0,0,4,0,44,27,71,7,82,88,162,71,0,0,233,0,14,0,4,4,0,10,10,219
Goa,2 - Attempt to commit Rape (Section 376 & 511 IPC),2014,0,0,2,2,2,0,0,0,0,0,0,0,0,0,0,0,2,0,0,0,0,0,0,0,0,0,0,0,0,0,0
Goa,"3 - Kidnapping & Abduction of Women (Section 363,364,364A, 366-369 IPC)",2014,47,0,86,86,92,0,0,0,0,36,1,9,7,16,13,66,67,57,16,0,0,73,0,2,0,0,0,0,2,2,71
Goa,3.1 - Kidnaping & Abduction Section 363 IPC,2014,45,0,77,77,82,0,0,0,0,34,1,9,7,16,8,59,63,53,16,0,0,69,0,2,0,0,0,0,2,2,67
Goa,3.2 - Kidnaping & Abduction in order to Murder Section 364 IPC,2014,0,0,0,0,0,0,0,0,0,0,0,0,0,0,0,0,0,0,0,0,0,0,0,0,0,0,0,0,0,0,0
Goa,3.3 - Kidnapping for Ransom Section 364A,2014,0,0,0,0,0,0,0,0,0,0,0,0,0,0,0,0,0,0,0,0,0,0,0,0,0,0,0,0,0,0,0
Goa,3.4 - Kidnapping & Abduction of Women to compel her for marriage,2014,0,0,0,0,0,0,0,0,0,0,0,0,0,0,0,0,0,1,0,0,0,1,0,0,0,0,0,0,0,0,1
Goa,3.5 - Kidnapping & Abduction of Women-Other,2014,2,0,9,9,10,0,0,0,0,2,0,0,0,0,5,7,4,3,0,0,0,3,0,0,0,0,0,0,0,0,3
Goa,4 - Dowry Deaths (Section 304-B IPC),2014,0,0,0,0,0,0,0,0,0,0,0,0,0,0,0,0,0,8,0,0,0,8,0,0,0,0,0,0,0,0,8
Goa,5 - Assault on Women with intent to outrage her Modesty_Total (Section 354 IPC),2014,104,1,201,202,219,0,0,0,2,6,0,100,52,152,22,182,124,171,152,0,0,323,3,32,1,5,6,3,23,26,288
Goa,5.1 - Sexual Harassment,2014,19,0,50,50,57,0,0,0,0,2,0,22,10,32,5,39,30,13,32,0,0,45,0,2,0,0,0,0,2,2,43
Goa,5.2 - Assault on women with intent to Disrobe,2014,4,0,7,7,7,0,0,0,1,0,0,4,2,6,1,8,3,0,6,0,0,6,0,1,0,0,0,0,1,1,5
Goa,5.3 - Voyeurism,2014,2,0,11,11,16,0,0,0,0,0,0,3,0,3,1,4,9,2,3,0,0,5,0,2,0,1,1,1,0,1,3
Goa,5.4 - Stalking,2014,10,0,25,25,27,0,0,0,0,0,0,10,7,17,3,20,15,7,17,0,0,24,0,2,0,1,1,0,1,1,22
Goa,5.5 - Others,2014,69,1,108,109,112,0,0,0,1,4,0,61,33,94,12,111,67,149,94,0,0,243,3,25,1,3,4,2,19,21,215
Goa,6 - Insult to the Modesty of Women_Total (Section 509 IPC),2014,34,0,57,57,59,0,0,0,0,2,0,27,17,44,8,54,37,54,44,0,0,98,0,12,0,2,2,0,10,10,86
Goa,6.1 - At Office premises,2014,0,0,1,1,1,0,0,0,0,0,0,1,0,1,0,1,0,0,1,0,0,1,0,0,0,0,0,0,0,0,1
Goa,6.2 - Other places related to work,2014,1,0,1,1,1,0,0,0,0,0,0,0,0,0,0,0,2,0,0,0,0,0,0,0,0,0,0,0,0,0,0
Goa,6.3 - In Public Transport system,2014,0,0,0,0,0,0,0,0,0,0,0,0,0,0,0,0,0,0,0,0,0,0,0,0,0,0,0,0,0,0,0
Goa,6.4 - in Other Places,2014,33,0,55,55,57,0,0,0,0,2,0,26,17,43,8,53,35,54,43,0,0,97,0,12,0,2,2,0,10,10,85
Goa,7 - Cruelty by Husband or his Relatives (Section 498A),2014,37,0,35,35,36,0,0,0,0,4,0,11,18,29,3,36,36,66,29,0,0,95,0,19,0,1,1,1,17,18,76
Goa,8 - Importation of Girls from Foreign Country (Section 366B IPC),2014,0,0,0,0,0,0,0,0,0,0,0,0,0,0,0,0,0,0,0,0,0,0,0,0,0,0,0,0,0,0,0
Goa,9 - Abetment of Suicides of Women u/s 306 IPC,2014,1,0,0,0,0,0,0,0,0,1,0,0,0,0,0,1,0,0,0,0,0,0,0,0,0,0,0,0,0,0,0
Goa,"10 - Dowry Prohibition Act, 1961",2014,0,0,0,0,0,0,0,0,0,0,0,0,0,0,0,0,0,0,0,0,0,0,0,0,0,0,0,0,0,0,0
Goa,"11 - Indecent Representation of Women (Prohibition) Act, 1986",2014,0,0,0,0,0,0,0,0,0,0,0,0,0,0,0,0,0,4,0,0,0,4,0,4,0,0,0,0,4,4,0
Goa,12 - Commission of Sati Prevention Act 1987,2014,0,0,0,0,0,0,0,0,0,0,0,0,0,0,0,0,0,0,0,0,0,0,0,0,0,0,0,0,0,0,0
Goa,"13 - Protection of Women from Domestic Violence Act, 2005",2014,0,0,2,2,2,0,0,0,0,0,0,1,0,1,0,1,1,1,1,0,0,2,0,0,0,0,0,0,0,0,2
Goa,14 - Immoral Traffic (Prevention) Act (Women Cases only),2014,44,0,9,9,22,0,0,0,0,1,0,0,6,6,1,8,45,52,6,0,0,58,0,2,0,1,1,0,1,1,56
Goa,14.1 - Under ITP Section 5,2014,9,0,5,5,11,0,0,0,0,0,0,0,5,5,1,6,8,18,5,0,0,23,0,2,0,1,1,0,1,1,21
Goa,14.2 - Under ITP Section 6,2014,0,0,0,0,0,0,0,0,0,0,0,0,0,0,0,0,0,0,0,0,0,0,0,0,0,0,0,0,0,0,0
Goa,14.3 - Under ITP Section 7,2014,0,0,0,0,0,0,0,0,0,0,0,0,0,0,0,0,0,7,0,0,0,7,0,0,0,0,0,0,0,0,7
Goa,14.4 - Under ITP Section 8,2014,0,0,0,0,0,0,0,0,0,0,0,0,0,0,0,0,0,8,0,0,0,8,0,0,0,0,0,0,0,0,8
Goa,14.5 - Other Sections under ITP Act,2014,35,0,4,4,11,0,0,0,0,1,0,0,1,1,0,2,37,19,1,0,0,20,0,0,0,0,0,0,0,0,20
Goa,15 - Total Crimes against Women,2014,345,1,487,488,531,0,0,0,2,54,1,193,128,321,54,432,401,576,321,0,0,897,3,85,1,13,14,4,67,71,809
Gujarat,1 - Rape (Section 376 IPC),2014,111,10,831,841,846,9,0,2,11,6,1,667,95,762,15,795,146,3100,762,1,2,3859,1,281,3,27,30,7,244,251,3577
Gujarat,1.1 - Custodial Rape,2014,0,0,0,0,0,0,0,0,0,0,0,0,0,0,0,0,0,0,0,0,0,0,0,0,0,0,0,0,0,0,0
Gujarat,1.1.1 - Custodial_Gang Rape,2014,0,0,0,0,0,0,0,0,0,0,0,0,0,0,0,0,0,0,0,0,0,0,0,0,0,0,0,0,0,0,0
Gujarat,1.1.2 - Custodial_Other Rape,2014,0,0,0,0,0,0,0,0,0,0,0,0,0,0,0,0,0,0,0,0,0,0,0,0,0,0,0,0,0,0,0
Gujarat,1.2 - Rape other than Custodial,2014,111,10,831,841,846,9,0,2,11,6,1,667,95,762,15,795,146,3100,762,1,2,3859,1,281,3,27,30,7,244,251,3577
Gujarat,1.2.1 - Rape_Gang Rape,2014,0,0,16,16,17,0,0,0,1,0,0,14,0,14,0,15,1,4,14,0,0,18,0,1,0,1,1,0,0,0,17
Gujarat,1.2.2 - Rape_Others,2014,111,10,815,825,829,9,0,2,10,6,1,653,95,748,15,780,145,3096,748,1,2,3841,1,280,3,26,29,7,244,251,3560
Gujarat,2 - Attempt to commit Rape (Section 376 & 511 IPC),2014,0,0,6,6,6,0,0,0,0,0,0,5,0,5,0,5,1,0,5,0,0,5,0,1,0,0,0,0,1,1,4
Gujarat,"3 - Kidnapping & Abduction of Women (Section 363,364,364A, 366-369 IPC)",2014,446,9,2178,2187,2234,16,2,7,21,226,5,1252,317,1569,264,2085,523,7037,1569,0,1,8605,5,423,6,29,35,10,378,388,8177
Gujarat,3.1 - Kidnaping & Abduction Section 363 IPC,2014,107,3,614,617,655,2,0,1,7,83,5,320,80,400,51,546,175,1293,400,0,1,1692,0,102,0,4,4,3,95,98,1590
Gujarat,3.2 - Kidnaping & Abduction in order to Murder Section 364 IPC,2014,0,0,0,0,0,0,0,0,0,0,0,0,0,0,0,0,0,0,0,0,0,0,0,0,0,0,0,0,0,0,0
Gujarat,3.3 - Kidnapping for Ransom Section 364A,2014,0,0,2,2,2,0,0,1,0,0,0,0,0,0,1,1,0,1,0,0,0,1,0,0,0,0,0,0,0,0,1
Gujarat,3.4 - Kidnapping & Abduction of Women to compel her for marriage,2014,323,3,1375,1378,1382,13,2,5,11,105,0,835,225,1060,194,1370,311,5551,1060,0,0,6611,3,309,5,23,28,6,275,281,6299
Gujarat,3.5 - Kidnapping & Abduction of Women-Other,2014,16,3,187,190,195,1,0,0,3,38,0,97,12,109,18,168,37,192,109,0,0,301,2,12,1,2,3,1,8,9,287
Gujarat,4 - Dowry Deaths (Section 304-B IPC),2014,1,0,23,23,23,0,0,0,0,0,0,21,1,22,1,23,1,359,22,0,0,381,0,14,0,1,1,0,13,13,367
Gujarat,5 - Assault on Women with intent to outrage her Modesty_Total (Section 354 IPC),2014,135,5,1347,1352,1356,0,0,0,11,1,1,1197,126,1323,16,1352,135,7277,1323,0,0,8600,21,571,1,9,10,19,542,561,8008
Gujarat,5.1 - Sexual Harassment,2014,23,4,401,405,406,0,0,0,5,0,0,357,22,379,2,386,42,1198,379,0,0,1577,0,68,0,1,1,2,65,67,1509
Gujarat,5.2 - Assault on women with intent to Disrobe,2014,3,0,51,51,51,0,0,0,0,0,0,47,3,50,1,51,3,115,50,0,0,165,1,20,0,0,0,3,17,20,144
Gujarat,5.3 - Voyeurism,2014,0,0,7,7,7,0,0,0,0,0,0,5,0,5,0,5,2,9,5,0,0,14,0,2,0,0,0,1,1,2,12
Gujarat,5.4 - Stalking,2014,0,0,62,62,62,0,0,0,1,0,0,46,0,46,1,48,14,11,46,0,0,57,0,0,0,0,0,0,0,0,57
Gujarat,5.5 - Others,2014,109,1,826,827,830,0,0,0,5,1,1,742,101,843,12,862,74,5944,843,0,0,6787,20,481,1,8,9,13,459,472,6286
Gujarat,6 - Insult to the Modesty of Women_Total (Section 509 IPC),2014,17,0,173,173,174,0,0,0,1,0,0,154,12,166,11,178,12,738,166,0,0,904,2,89,10,11,21,5,63,68,813
Gujarat,6.1 - At Office premises,2014,0,0,1,1,1,0,0,0,0,0,0,1,0,1,0,1,0,7,1,0,0,8,0,0,0,0,0,0,0,0,8
Gujarat,6.2 - Other places related to work,2014,1,0,3,3,3,0,0,0,0,0,0,3,1,4,0,4,0,5,4,0,0,9,0,2,0,0,0,0,2,2,7
Gujarat,6.3 - In Public Transport system,2014,0,0,0,0,0,0,0,0,0,0,0,0,0,0,0,0,0,0,0,0,0,0,0,0,0,0,0,0,0,0,0
Gujarat,6.4 - in Other Places,2014,16,0,169,169,170,0,0,0,1,0,0,150,11,161,11,173,12,726,161,0,0,887,2,87,10,11,21,5,61,66,798
Gujarat,7 - Cruelty by Husband or his Relatives (Section 498A),2014,715,11,5980,5991,6002,14,0,2,9,19,4,5276,779,6055,26,6113,577,39079,6055,6,2,45126,300,3104,9,67,76,148,2880,3028,41722
Gujarat,8 - Importation of Girls from Foreign Country (Section 366B IPC),2014,0,0,0,0,0,0,0,0,0,0,0,0,0,0,0,0,0,0,0,0,0,0,0,0,0,0,0,0,0,0,0
Gujarat,9 - Abetment of Suicides of Women u/s 306 IPC,2014,10,0,164,164,166,0,0,0,0,0,0,141,10,151,1,152,22,291,151,0,0,442,1,18,0,1,1,1,16,17,423
Gujarat,"10 - Dowry Prohibition Act, 1961",2014,11,2,51,53,53,2,0,0,0,0,0,40,11,51,0,51,11,70,51,0,0,121,0,7,0,0,0,0,7,7,114
Gujarat,"11 - Indecent Representation of Women (Prohibition) Act, 1986",2014,0,0,0,0,0,0,0,0,0,0,0,0,0,0,0,0,0,6,0,0,0,6,0,0,0,0,0,0,0,0,6
Gujarat,12 - Commission of Sati Prevention Act 1987,2014,0,0,0,0,0,0,0,0,0,0,0,0,0,0,0,0,0,0,0,0,0,0,0,0,0,0,0,0,0,0,0
Gujarat,"13 - Protection of Women from Domestic Violence Act, 2005",2014,0,0,2,2,2,0,0,0,0,0,0,2,0,2,0,2,0,5,2,0,0,7,0,1,0,0,0,0,1,1,6
Gujarat,14 - Immoral Traffic (Prevention) Act (Women Cases only),2014,1,0,45,45,70,0,0,0,0,0,0,41,1,42,0,42,4,60,42,0,0,102,0,0,0,0,0,0,0,0,102
Gujarat,14.1 - Under ITP Section 5,2014,1,0,18,18,40,0,0,0,0,0,0,16,1,17,0,17,2,46,17,0,0,63,0,0,0,0,0,0,0,0,63
Gujarat,14.2 - Under ITP Section 6,2014,0,0,5,5,7,0,0,0,0,0,0,4,0,4,0,4,1,0,4,0,0,4,0,0,0,0,0,0,0,0,4
Gujarat,14.3 - Under ITP Section 7,2014,0,0,1,1,1,0,0,0,0,0,0,1,0,1,0,1,0,3,1,0,0,4,0,0,0,0,0,0,0,0,4
Gujarat,14.4 - Under ITP Section 8,2014,0,0,3,3,3,0,0,0,0,0,0,3,0,3,0,3,0,0,3,0,0,3,0,0,0,0,0,0,0,0,3
Gujarat,14.5 - Other Sections under ITP Act,2014,0,0,18,18,19,0,0,0,0,0,0,17,0,17,0,17,1,11,17,0,0,28,0,0,0,0,0,0,0,0,28
Gujarat,15 - Total Crimes against Women,2014,1447,37,10800,10837,10932,41,2,11,53,252,11,8796,1352,10148,334,10798,1432,58022,10148,7,5,68158,330,4509,29,145,174,190,4145,4335,63319
Haryana,1 - Rape (Section 376 IPC),2014,81,9,1165,1174,1183,0,0,0,197,0,0,862,70,932,11,1140,115,979,932,0,0,1911,0,791,30,175,205,233,353,586,1120
Haryana,1.1 - Custodial Rape,2014,0,0,0,0,0,0,0,0,0,0,0,0,0,0,0,0,0,0,0,0,0,0,0,0,0,0,0,0,0,0,0
Haryana,1.1.1 - Custodial_Gang Rape,2014,0,0,0,0,0,0,0,0,0,0,0,0,0,0,0,0,0,0,0,0,0,0,0,0,0,0,0,0,0,0,0
Haryana,1.1.2 - Custodial_Other Rape,2014,0,0,0,0,0,0,0,0,0,0,0,0,0,0,0,0,0,0,0,0,0,0,0,0,0,0,0,0,0,0,0
Haryana,1.2 - Rape other than Custodial,2014,81,9,1165,1174,1183,0,0,0,197,0,0,862,70,932,11,1140,115,979,932,0,0,1911,0,791,30,175,205,233,353,586,1120
Haryana,1.2.1 - Rape_Gang Rape,2014,3,0,230,230,231,0,0,0,49,0,0,157,3,160,4,213,20,24,160,0,0,184,0,51,0,6,6,27,18,45,133
Haryana,1.2.2 - Rape_Others,2014,78,9,935,944,952,0,0,0,148,0,0,705,67,772,7,927,95,955,772,0,0,1727,0,740,30,169,199,206,335,541,987
Haryana,2 - Attempt to commit Rape (Section 376 & 511 IPC),2014,0,0,136,136,136,0,0,0,21,0,0,104,0,104,1,126,10,69,104,0,0,173,0,71,12,2,14,23,34,57,102
Haryana,"3 - Kidnapping & Abduction of Women (Section 363,364,364A, 366-369 IPC)",2014,326,3,1919,1922,2023,0,0,0,1116,0,12,469,165,634,131,1893,355,1628,634,0,0,2262,30,711,17,131,148,106,457,563,1521
Haryana,3.1 - Kidnaping & Abduction Section 363 IPC,2014,25,0,113,113,119,0,0,0,73,0,0,33,10,43,7,123,15,115,43,0,0,158,0,16,0,1,1,3,12,15,142
Haryana,3.2 - Kidnaping & Abduction in order to Murder Section 364 IPC,2014,0,0,5,5,5,0,0,0,2,0,0,3,0,3,0,5,0,0,3,0,0,3,0,1,0,0,0,1,0,1,2
Haryana,3.3 - Kidnapping for Ransom Section 364A,2014,0,0,1,1,1,0,0,0,0,0,0,1,0,1,0,1,0,1,1,0,0,2,0,0,0,0,0,0,0,0,2
Haryana,3.4 - Kidnapping & Abduction of Women to compel her for marriage,2014,224,3,883,886,889,0,0,0,537,0,1,266,105,371,37,946,164,1225,371,0,0,1596,0,515,9,107,116,67,332,399,1081
Haryana,3.5 - Kidnapping & Abduction of Women-Other,2014,77,0,917,917,1009,0,0,0,504,0,11,166,50,216,87,818,176,287,216,0,0,503,30,179,8,23,31,35,113,148,294
Haryana,4 - Dowry Deaths (Section 304-B IPC),2014,27,1,292,293,300,0,0,0,32,0,0,235,21,256,1,289,31,439,256,0,0,695,0,221,9,48,57,40,124,164,474
Haryana,5 - Assault on Women with intent to outrage her Modesty_Total (Section 354 IPC),2014,96,41,1647,1688,1699,0,0,0,318,0,0,1229,74,1303,28,1649,135,2124,1303,0,0,3427,0,826,31,133,164,151,511,662,2601
Haryana,5.1 - Sexual Harassment,2014,13,11,588,599,602,0,0,0,116,0,0,440,8,448,5,569,43,218,448,0,0,666,0,136,10,14,24,63,49,112,530
Haryana,5.2 - Assault on women with intent to Disrobe,2014,1,2,227,229,230,0,0,0,40,0,0,174,1,175,2,217,13,27,175,0,0,202,0,49,6,6,12,24,13,37,153
Haryana,5.3 - Voyeurism,2014,0,0,26,26,26,0,0,0,2,0,0,20,0,20,0,22,4,4,20,0,0,24,0,1,0,0,0,1,0,1,23
Haryana,5.4 - Stalking,2014,5,2,282,284,286,0,0,0,37,0,0,222,4,226,5,268,21,73,226,0,0,299,0,67,6,8,14,24,29,53,232
Haryana,5.5 - Others,2014,77,26,524,550,555,0,0,0,123,0,0,373,61,434,16,573,54,1802,434,0,0,2236,0,573,9,105,114,39,420,459,1663
Haryana,6 - Insult to the Modesty of Women_Total (Section 509 IPC),2014,26,1,101,102,103,0,0,0,37,0,0,67,2,69,5,111,17,1007,69,0,0,1076,0,874,1,3,4,6,864,870,202
Haryana,6.1 - At Office premises,2014,0,0,1,1,1,0,0,0,1,0,0,0,0,0,0,1,0,0,0,0,0,0,0,0,0,0,0,0,0,0,0
Haryana,6.2 - Other places related to work,2014,0,0,1,1,1,0,0,0,0,0,0,1,0,1,0,1,0,2,1,0,0,3,0,0,0,0,0,0,0,0,3
Haryana,6.3 - In Public Transport system,2014,0,0,2,2,2,0,0,0,0,0,0,1,0,1,0,1,1,2,1,0,0,3,0,0,0,0,0,0,0,0,3
Haryana,6.4 - in Other Places,2014,26,1,97,98,99,0,0,0,36,0,0,65,2,67,5,108,16,1003,67,0,0,1070,0,874,1,3,4,6,864,870,196
Haryana,7 - Cruelty by Husband or his Relatives (Section 498A),2014,617,1091,2387,3478,3501,0,0,0,827,0,1,1851,437,2288,184,3300,795,7259,2288,0,0,9547,10,1578,4,85,89,32,1457,1489,7959
Haryana,8 - Importation of Girls from Foreign Country (Section 366B IPC),2014,0,0,0,0,0,0,0,0,0,0,0,0,0,0,0,0,0,1,0,0,0,1,1,0,0,0,0,0,0,0,0
Haryana,9 - Abetment of Suicides of Women u/s 306 IPC,2014,1,0,120,120,120,0,0,0,20,0,0,83,1,84,0,104,17,55,84,0,0,139,0,28,0,4,4,7,17,24,111
Haryana,"10 - Dowry Prohibition Act, 1961",2014,2,0,13,13,13,0,0,0,7,0,0,5,1,6,1,14,1,22,6,0,0,28,0,7,0,0,0,1,6,7,21
Haryana,"11 - Indecent Representation of Women (Prohibition) Act, 1986",2014,0,0,1,1,1,0,0,0,0,0,0,0,0,0,1,1,0,2,0,0,0,2,1,0,0,0,0,0,0,0,1
Haryana,12 - Commission of Sati Prevention Act 1987,2014,0,0,0,0,0,0,0,0,0,0,0,0,0,0,0,0,0,0,0,0,0,0,0,0,0,0,0,0,0,0,0
Haryana,"13 - Protection of Women from Domestic Violence Act, 2005",2014,5,1,3,4,8,0,0,0,2,0,0,1,4,5,0,7,2,15,5,0,0,20,0,2,0,0,0,0,2,2,18
Haryana,14 - Immoral Traffic (Prevention) Act (Women Cases only),2014,2,0,43,43,67,0,0,0,0,0,0,38,2,40,0,40,5,142,40,0,0,182,0,19,0,5,5,0,14,14,163
Haryana,14.1 - Under ITP Section 5,2014,2,0,17,17,36,0,0,0,0,0,0,15,2,17,0,17,2,53,17,0,0,70,0,10,0,2,2,0,8,8,60
Haryana,14.2 - Under ITP Section 6,2014,0,0,9,9,9,0,0,0,0,0,0,8,0,8,0,8,1,7,8,0,0,15,0,0,0,0,0,0,0,0,15
Haryana,14.3 - Under ITP Section 7,2014,0,0,1,1,1,0,0,0,0,0,0,1,0,1,0,1,0,1,1,0,0,2,0,0,0,0,0,0,0,0,2
Haryana,14.4 - Under ITP Section 8,2014,0,0,0,0,0,0,0,0,0,0,0,0,0,0,0,0,0,1,0,0,0,1,0,0,0,0,0,0,0,0,1
Haryana,14.5 - Other Sections under ITP Act,2014,0,0,16,16,21,0,0,0,0,0,0,14,0,14,0,14,2,80,14,0,0,94,0,9,0,3,3,0,6,6,85
Haryana,15 - Total Crimes against Women,2014,1183,1147,7827,8974,9154,0,0,0,2577,0,13,4944,777,5721,363,8674,1483,13742,5721,0,0,19463,42,5128,104,586,690,599,3839,4438,14293
Himachal Pradesh,1 - Rape (Section 376 IPC),2014,60,4,279,283,284,0,0,1,43,7,0,164,43,207,1,258,84,498,207,0,0,705,1,106,1,35,36,2,68,70,598
Himachal Pradesh,1.1 - Custodial Rape,2014,0,0,0,0,0,0,0,0,0,0,0,0,0,0,0,0,0,0,0,0,0,0,0,0,0,0,0,0,0,0,0
Himachal Pradesh,1.1.1 - Custodial_Gang Rape,2014,0,0,0,0,0,0,0,0,0,0,0,0,0,0,0,0,0,0,0,0,0,0,0,0,0,0,0,0,0,0,0
Himachal Pradesh,1.1.2 - Custodial_Other Rape,2014,0,0,0,0,0,0,0,0,0,0,0,0,0,0,0,0,0,0,0,0,0,0,0,0,0,0,0,0,0,0,0
Himachal Pradesh,1.2 - Rape other than Custodial,2014,60,4,279,283,284,0,0,1,43,7,0,164,43,207,1,258,84,498,207,0,0,705,1,106,1,35,36,2,68,70,598
Himachal Pradesh,1.2.1 - Rape_Gang Rape,2014,0,0,6,6,6,0,0,0,0,0,0,6,0,6,0,6,0,1,6,0,0,7,0,0,0,0,0,0,0,0,7
Himachal Pradesh,1.2.2 - Rape_Others,2014,60,4,273,277,278,0,0,1,43,7,0,158,43,201,1,252,84,497,201,0,0,698,1,106,1,35,36,2,68,70,591
Himachal Pradesh,2 - Attempt to commit Rape (Section 376 & 511 IPC),2014,0,1,4,5,5,0,0,0,0,1,0,3,0,3,0,4,1,5,3,0,0,8,0,1,0,0,0,0,1,1,7
Himachal Pradesh,"3 - Kidnapping & Abduction of Women (Section 363,364,364A, 366-369 IPC)",2014,85,4,223,227,242,0,0,1,135,34,0,32,23,55,10,234,77,272,55,0,0,327,1,37,0,3,3,2,32,34,289
Himachal Pradesh,3.1 - Kidnaping & Abduction Section 363 IPC,2014,7,0,32,32,32,0,0,0,18,3,0,3,1,4,2,27,12,26,4,0,0,30,0,4,0,1,1,0,3,3,26
Himachal Pradesh,3.2 - Kidnaping & Abduction in order to Murder Section 364 IPC,2014,0,1,0,1,1,0,0,0,1,0,0,0,0,0,0,1,0,0,0,0,0,0,0,0,0,0,0,0,0,0,0
Himachal Pradesh,3.3 - Kidnapping for Ransom Section 364A,2014,0,0,1,1,1,0,0,0,0,0,0,1,0,1,0,1,0,0,1,0,0,1,0,0,0,0,0,0,0,0,1
Himachal Pradesh,3.4 - Kidnapping & Abduction of Women to compel her for marriage,2014,72,3,172,175,179,0,0,1,106,31,0,21,20,41,8,186,60,232,41,0,0,273,1,30,0,2,2,1,27,28,242
Himachal Pradesh,3.5 - Kidnapping & Abduction of Women-Other,2014,6,0,18,18,29,0,0,0,10,0,0,7,2,9,0,19,5,14,9,0,0,23,0,3,0,0,0,1,2,3,20
Himachal Pradesh,4 - Dowry Deaths (Section 304-B IPC),2014,0,0,1,1,1,0,0,0,0,0,0,1,0,1,0,1,0,19,1,0,0,20,0,1,0,1,1,0,0,0,19
Himachal Pradesh,5 - Assault on Women with intent to outrage her Modesty_Total (Section 354 IPC),2014,104,15,523,538,538,0,0,0,45,12,0,372,88,460,10,527,115,1932,460,0,0,2392,19,221,0,23,23,0,198,198,2152
Himachal Pradesh,5.1 - Sexual Harassment,2014,26,2,157,159,159,0,0,0,17,2,0,99,27,126,4,149,36,304,126,0,0,430,1,70,0,4,4,0,66,66,359
Himachal Pradesh,5.2 - Assault on women with intent to Disrobe,2014,0,3,15,18,18,0,0,0,2,0,0,12,0,12,0,14,4,0,12,0,0,12,0,0,0,0,0,0,0,0,12
Himachal Pradesh,5.3 - Voyeurism,2014,1,0,3,3,3,0,0,0,1,0,0,2,0,2,0,3,1,0,2,0,0,2,0,0,0,0,0,0,0,0,2
Himachal Pradesh,5.4 - Stalking,2014,2,0,62,62,62,0,0,0,4,1,0,40,2,42,1,48,16,1,42,0,0,43,0,0,0,0,0,0,0,0,43
Himachal Pradesh,5.5 - Others,2014,75,10,286,296,296,0,0,0,21,9,0,219,59,278,5,313,58,1627,278,0,0,1905,18,151,0,19,19,0,132,132,1736
Himachal Pradesh,6 - Insult to the Modesty of Women_Total (Section 509 IPC),2014,0,0,60,60,60,0,0,0,0,1,0,47,0,47,7,55,5,62,47,0,0,109,4,6,0,0,0,6,0,6,99
Himachal Pradesh,6.1 - At Office premises,2014,0,0,0,0,0,0,0,0,0,0,0,0,0,0,0,0,0,0,0,0,0,0,0,0,0,0,0,0,0,0,0
Himachal Pradesh,6.2 - Other places related to work,2014,0,0,0,0,0,0,0,0,0,0,0,0,0,0,0,0,0,0,0,0,0,0,0,0,0,0,0,0,0,0,0
Himachal Pradesh,6.3 - In Public Transport system,2014,0,0,0,0,0,0,0,0,0,0,0,0,0,0,0,0,0,0,0,0,0,0,0,0,0,0,0,0,0,0,0
Himachal Pradesh,6.4 - in Other Places,2014,0,0,60,60,60,0,0,0,0,1,0,47,0,47,7,55,5,62,47,0,0,109,4,6,0,0,0,6,0,6,99
Himachal Pradesh,7 - Cruelty by Husband or his Relatives (Section 498A),2014,66,77,248,325,371,0,0,0,30,9,0,230,52,282,1,322,69,1379,282,2,0,1659,46,84,0,6,6,6,72,78,1529
Himachal Pradesh,8 - Importation of Girls from Foreign Country (Section 366B IPC),2014,0,0,0,0,0,0,0,0,0,0,0,0,0,0,0,0,0,0,0,0,0,0,0,0,0,0,0,0,0,0,0
Himachal Pradesh,9 - Abetment of Suicides of Women u/s 306 IPC,2014,22,0,66,66,68,0,0,0,4,4,0,42,13,55,3,66,22,194,55,0,0,249,1,22,0,0,0,2,20,22,226
Himachal Pradesh,"10 - Dowry Prohibition Act, 1961",2014,2,0,2,2,2,0,0,0,1,0,0,0,1,1,0,2,2,10,1,0,0,11,0,0,0,0,0,0,0,0,11
Himachal Pradesh,"11 - Indecent Representation of Women (Prohibition) Act, 1986",2014,0,0,0,0,0,0,0,0,0,0,0,0,0,0,0,0,0,0,0,0,0,0,0,0,0,0,0,0,0,0,0
Himachal Pradesh,12 - Commission of Sati Prevention Act 1987,2014,0,0,0,0,0,0,0,0,0,0,0,0,0,0,0,0,0,0,0,0,0,0,0,0,0,0,0,0,0,0,0
Himachal Pradesh,"13 - Protection of Women from Domestic Violence Act, 2005",2014,0,5,0,5,5,0,0,0,0,0,0,4,0,4,0,4,1,2,4,0,0,6,0,0,0,0,0,0,0,0,6
Himachal Pradesh,14 - Immoral Traffic (Prevention) Act (Women Cases only),2014,1,0,5,5,5,0,0,0,0,1,0,1,1,2,0,3,3,12,2,0,0,14,0,1,0,0,0,0,1,1,13
Himachal Pradesh,14.1 - Under ITP Section 5,2014,0,0,3,3,3,0,0,0,0,1,0,0,0,0,0,1,2,7,0,0,0,7,0,1,0,0,0,0,1,1,6
Himachal Pradesh,14.2 - Under ITP Section 6,2014,0,0,1,1,1,0,0,0,0,0,0,1,0,1,0,1,0,0,1,0,0,1,0,0,0,0,0,0,0,0,1
Himachal Pradesh,14.3 - Under ITP Section 7,2014,0,0,0,0,0,0,0,0,0,0,0,0,0,0,0,0,0,0,0,0,0,0,0,0,0,0,0,0,0,0,0
Himachal Pradesh,14.4 - Under ITP Section 8,2014,0,0,0,0,0,0,0,0,0,0,0,0,0,0,0,0,0,0,0,0,0,0,0,0,0,0,0,0,0,0,0
Himachal Pradesh,14.5 - Other Sections under ITP Act,2014,1,0,1,1,1,0,0,0,0,0,0,0,1,1,0,1,1,5,1,0,0,6,0,0,0,0,0,0,0,0,6
Himachal Pradesh,15 - Total Crimes against Women,2014,340,106,1411,1517,1581,0,0,2,258,69,0,896,221,1117,32,1476,379,4385,1117,2,0,5500,72,479,1,68,69,18,392,410,4949
Jammu & Kashmir,1 - Rape (Section 376 IPC),2014,109,49,282,331,332,0,0,0,79,0,0,183,42,225,2,306,134,893,225,0,0,1118,2,272,3,15,18,38,216,254,844
Jammu & Kashmir,1.1 - Custodial Rape,2014,0,0,0,0,0,0,0,0,0,0,0,0,0,0,0,0,0,0,0,0,0,0,0,0,0,0,0,0,0,0,0
Jammu & Kashmir,1.1.1 - Custodial_Gang Rape,2014,0,0,0,0,0,0,0,0,0,0,0,0,0,0,0,0,0,0,0,0,0,0,0,0,0,0,0,0,0,0,0
Jammu & Kashmir,1.1.2 - Custodial_Other Rape,2014,0,0,0,0,0,0,0,0,0,0,0,0,0,0,0,0,0,0,0,0,0,0,0,0,0,0,0,0,0,0,0
Jammu & Kashmir,1.2 - Rape other than Custodial,2014,109,49,282,331,332,0,0,0,79,0,0,183,42,225,2,306,134,893,225,0,0,1118,2,272,3,15,18,38,216,254,844
Jammu & Kashmir,1.2.1 - Rape_Gang Rape,2014,0,0,0,0,0,0,0,0,0,0,0,0,0,0,0,0,0,1,0,0,0,1,0,0,0,0,0,0,0,0,1
Jammu & Kashmir,1.2.2 - Rape_Others,2014,109,49,282,331,332,0,0,0,79,0,0,183,42,225,2,306,134,892,225,0,0,1117,2,272,3,15,18,38,216,254,843
Jammu & Kashmir,2 - Attempt to commit Rape (Section 376 & 511 IPC),2014,0,3,17,20,20,0,0,0,2,0,0,13,0,13,0,15,5,16,13,0,0,29,1,1,0,0,0,0,1,1,27
Jammu & Kashmir,"3 - Kidnapping & Abduction of Women (Section 363,364,364A, 366-369 IPC)",2014,382,64,749,813,816,0,0,0,381,0,0,252,69,321,18,720,475,3321,321,0,0,3642,9,383,3,2,5,15,363,378,3250
Jammu & Kashmir,3.1 - Kidnaping & Abduction Section 363 IPC,2014,142,11,274,285,288,0,0,0,127,0,0,96,18,114,8,249,178,980,114,0,0,1094,5,122,3,0,3,9,110,119,967
Jammu & Kashmir,3.2 - Kidnaping & Abduction in order to Murder Section 364 IPC,2014,2,0,1,1,1,0,0,0,2,0,0,0,0,0,0,2,1,13,0,0,0,13,0,1,0,0,0,0,1,1,12
Jammu & Kashmir,3.3 - Kidnapping for Ransom Section 364A,2014,0,0,0,0,0,0,0,0,0,0,0,0,0,0,0,0,0,0,0,0,0,0,0,0,0,0,0,0,0,0,0
Jammu & Kashmir,3.4 - Kidnapping & Abduction of Women to compel her for marriage,2014,120,11,225,236,236,0,0,0,110,0,0,69,22,91,2,203,153,810,91,0,0,901,4,80,0,0,0,2,78,80,817
Jammu & Kashmir,3.5 - Kidnapping & Abduction of Women-Other,2014,118,42,249,291,291,0,0,0,142,0,0,87,29,116,8,266,143,1518,116,0,0,1634,0,180,0,2,2,4,174,178,1454
Jammu & Kashmir,4 - Dowry Deaths (Section 304-B IPC),2014,1,0,5,5,5,0,0,0,0,0,0,5,0,5,0,5,1,57,5,0,0,62,0,2,0,0,0,0,2,2,60
Jammu & Kashmir,5 - Assault on Women with intent to outrage her Modesty_Total (Section 354 IPC),2014,237,174,1247,1421,1424,0,0,0,86,0,0,983,202,1185,5,1276,382,4553,1185,0,0,5738,277,658,6,26,32,37,589,626,4803
Jammu & Kashmir,5.1 - Sexual Harassment,2014,32,16,226,242,243,0,0,0,27,0,0,171,28,199,0,226,48,943,199,0,0,1142,56,135,1,4,5,11,119,130,951
Jammu & Kashmir,5.2 - Assault on women with intent to Disrobe,2014,31,1,122,123,123,0,0,0,2,0,0,95,9,104,0,106,48,160,104,0,0,264,21,46,0,0,0,0,46,46,197
Jammu & Kashmir,5.3 - Voyeurism,2014,0,0,0,0,0,0,0,0,0,0,0,0,0,0,0,0,0,0,0,0,0,0,0,0,0,0,0,0,0,0,0
Jammu & Kashmir,5.4 - Stalking,2014,0,1,0,1,1,0,0,0,0,0,0,1,0,1,0,1,0,0,1,0,0,1,0,0,0,0,0,0,0,0,1
Jammu & Kashmir,5.5 - Others,2014,174,156,899,1055,1057,0,0,0,57,0,0,716,165,881,5,943,286,3450,881,0,0,4331,200,477,5,22,27,26,424,450,3654
Jammu & Kashmir,6 - Insult to the Modesty of Women_Total (Section 509 IPC),2014,40,12,225,237,239,0,0,0,10,0,0,192,21,213,2,225,52,1036,213,0,0,1249,10,188,16,25,41,4,143,147,1051
Jammu & Kashmir,6.1 - At Office premises,2014,0,0,0,0,0,0,0,0,0,0,0,0,0,0,0,0,0,0,0,0,0,0,0,0,0,0,0,0,0,0,0
Jammu & Kashmir,6.2 - Other places related to work,2014,0,1,7,8,8,0,0,0,2,0,0,6,0,6,0,8,0,36,6,0,0,42,0,5,0,0,0,0,5,5,37
Jammu & Kashmir,6.3 - In Public Transport system,2014,1,0,6,6,6,0,0,0,1,0,0,6,0,6,0,7,0,26,6,0,0,32,0,17,0,1,1,0,16,16,15
Jammu & Kashmir,6.4 - in Other Places,2014,39,11,212,223,225,0,0,0,7,0,0,180,21,201,2,210,52,974,201,0,0,1175,10,166,16,24,40,4,122,126,999
Jammu & Kashmir,7 - Cruelty by Husband or his Relatives (Section 498A),2014,158,74,393,467,467,0,0,0,42,1,0,277,108,385,2,430,195,865,385,0,0,1250,103,90,0,5,5,2,83,85,1057
Jammu & Kashmir,8 - Importation of Girls from Foreign Country (Section 366B IPC),2014,0,0,0,0,0,0,0,0,0,0,0,0,0,0,0,0,0,0,0,0,0,0,0,0,0,0,0,0,0,0,0
Jammu & Kashmir,9 - Abetment of Suicides of Women u/s 306 IPC,2014,17,5,20,25,25,0,0,0,8,2,0,5,1,6,6,22,20,74,6,0,0,80,0,18,0,4,4,4,10,14,62
Jammu & Kashmir,"10 - Dowry Prohibition Act, 1961",2014,11,0,1,1,9,0,0,0,2,0,0,1,0,1,0,3,9,22,1,0,0,23,0,1,0,0,0,0,1,1,22
Jammu & Kashmir,"11 - Indecent Representation of Women (Prohibition) Act, 1986",2014,2,0,0,0,0,0,0,0,0,0,0,0,0,0,0,0,2,2,0,0,0,2,0,0,0,0,0,0,0,0,2
Jammu & Kashmir,12 - Commission of Sati Prevention Act 1987,2014,0,0,0,0,0,0,0,0,0,0,0,0,0,0,0,0,0,0,0,0,0,0,0,0,0,0,0,0,0,0,0
Jammu & Kashmir,"13 - Protection of Women from Domestic Violence Act, 2005",2014,0,0,0,0,0,0,0,0,0,0,0,0,0,0,0,0,0,0,0,0,0,0,0,0,0,0,0,0,0,0,0
Jammu & Kashmir,14 - Immoral Traffic (Prevention) Act (Women Cases only),2014,1,0,1,1,3,0,0,0,0,0,0,1,0,1,0,1,1,22,1,0,0,23,0,1,0,0,0,0,1,1,22
Jammu & Kashmir,14.1 - Under ITP Section 5,2014,0,0,1,1,3,0,0,0,0,0,0,1,0,1,0,1,0,3,1,0,0,4,0,0,0,0,0,0,0,0,4
Jammu & Kashmir,14.2 - Under ITP Section 6,2014,0,0,0,0,0,0,0,0,0,0,0,0,0,0,0,0,0,0,0,0,0,0,0,0,0,0,0,0,0,0,0
Jammu & Kashmir,14.3 - Under ITP Section 7,2014,0,0,0,0,0,0,0,0,0,0,0,0,0,0,0,0,0,0,0,0,0,0,0,0,0,0,0,0,0,0,0
Jammu & Kashmir,14.4 - Under ITP Section 8,2014,0,0,0,0,0,0,0,0,0,0,0,0,0,0,0,0,0,0,0,0,0,0,0,0,0,0,0,0,0,0,0
Jammu & Kashmir,14.5 - Other Sections under ITP Act,2014,1,0,0,0,0,0,0,0,0,0,0,0,0,0,0,0,1,19,0,0,0,19,0,1,0,0,0,0,1,1,18
Jammu & Kashmir,15 - Total Crimes against Women,2014,958,381,2940,3321,3340,0,0,0,610,3,0,1912,443,2355,35,3003,1276,10861,2355,0,0,13216,402,1614,28,77,105,100,1409,1509,11200
Jharkhand,1 - Rape (Section 376 IPC),2014,774,165,885,1050,1065,0,0,0,79,38,0,582,433,1015,37,1169,655,2031,1015,0,0,3046,54,663,75,170,245,90,328,418,2329
Jharkhand,1.1 - Custodial Rape,2014,0,0,0,0,0,0,0,0,0,0,0,0,0,0,0,0,0,0,0,0,0,0,0,0,0,0,0,0,0,0,0
Jharkhand,1.1.1 - Custodial_Gang Rape,2014,0,0,0,0,0,0,0,0,0,0,0,0,0,0,0,0,0,0,0,0,0,0,0,0,0,0,0,0,0,0,0
Jharkhand,1.1.2 - Custodial_Other Rape,2014,0,0,0,0,0,0,0,0,0,0,0,0,0,0,0,0,0,0,0,0,0,0,0,0,0,0,0,0,0,0,0
Jharkhand,1.2 - Rape other than Custodial,2014,774,165,885,1050,1065,0,0,0,79,38,0,582,433,1015,37,1169,655,2031,1015,0,0,3046,54,663,75,170,245,90,328,418,2329
Jharkhand,1.2.1 - Rape_Gang Rape,2014,8,5,47,52,52,0,0,0,3,0,0,27,0,27,0,30,30,7,27,0,0,34,0,7,1,1,2,2,3,5,27
Jharkhand,1.2.2 - Rape_Others,2014,766,160,838,998,1013,0,0,0,76,38,0,555,433,988,37,1139,625,2024,988,0,0,3012,54,656,74,169,243,88,325,413,2302
Jharkhand,2 - Attempt to commit Rape (Section 376 & 511 IPC),2014,4,39,169,208,208,0,0,0,16,4,1,88,26,114,18,153,59,4,114,0,0,118,1,38,7,4,11,9,18,27,79
Jharkhand,"3 - Kidnapping & Abduction of Women (Section 363,364,364A, 366-369 IPC)",2014,450,80,805,885,887,0,0,0,12,54,3,315,246,561,131,761,574,916,561,0,3,1474,6,420,33,85,118,57,245,302,1048
Jharkhand,3.1 - Kidnaping & Abduction Section 363 IPC,2014,1,0,26,26,26,0,0,0,0,3,0,6,1,7,0,10,17,11,7,0,0,18,0,0,0,0,0,0,0,0,18
Jharkhand,3.2 - Kidnaping & Abduction in order to Murder Section 364 IPC,2014,1,0,2,2,2,0,0,0,0,0,0,0,0,0,1,1,2,0,0,0,0,0,0,0,0,0,0,0,0,0,0
Jharkhand,3.3 - Kidnapping for Ransom Section 364A,2014,0,0,2,2,2,0,0,0,0,1,0,1,0,1,0,2,0,0,1,0,0,1,0,0,0,0,0,0,0,0,1
Jharkhand,3.4 - Kidnapping & Abduction of Women to compel her for marriage,2014,445,78,741,819,819,0,0,0,12,47,2,284,242,526,129,716,548,868,526,0,3,1391,6,415,31,85,116,57,242,299,970
Jharkhand,3.5 - Kidnapping & Abduction of Women-Other,2014,3,2,34,36,38,0,0,0,0,3,1,24,3,27,1,32,7,37,27,0,0,64,0,5,2,0,2,0,3,3,59
Jharkhand,4 - Dowry Deaths (Section 304-B IPC),2014,317,15,335,350,354,0,0,0,5,14,1,193,175,368,10,398,269,558,368,0,2,924,0,177,12,58,70,4,103,107,747
Jharkhand,5 - Assault on Women with intent to outrage her Modesty_Total (Section 354 IPC),2014,143,54,386,440,443,0,0,0,11,6,4,269,99,368,30,419,164,802,368,0,0,1170,2,183,23,42,65,22,96,118,985
Jharkhand,5.1 - Sexual Harassment,2014,42,14,100,114,114,0,0,0,5,3,2,82,30,112,2,124,32,136,112,0,0,248,0,36,3,8,11,12,13,25,212
Jharkhand,5.2 - Assault on women with intent to Disrobe,2014,29,16,49,65,65,0,0,0,2,1,0,48,7,55,2,60,34,6,55,0,0,61,0,14,0,2,2,0,12,12,47
Jharkhand,5.3 - Voyeurism,2014,0,0,0,0,0,0,0,0,0,0,0,0,0,0,0,0,0,0,0,0,0,0,0,0,0,0,0,0,0,0,0
Jharkhand,5.4 - Stalking,2014,0,0,5,5,5,0,0,0,0,0,0,3,0,3,1,4,1,0,3,0,0,3,0,0,0,0,0,0,0,0,3
Jharkhand,5.5 - Others,2014,72,24,232,256,259,0,0,0,4,2,2,136,62,198,25,231,97,660,198,0,0,858,2,133,20,32,52,10,71,81,723
Jharkhand,6 - Insult to the Modesty of Women_Total (Section 509 IPC),2014,36,1,17,18,18,0,0,0,1,0,0,16,20,36,14,51,3,74,36,0,1,109,0,18,0,0,0,2,16,18,91
Jharkhand,6.1 - At Office premises,2014,0,0,0,0,0,0,0,0,0,0,0,0,0,0,0,0,0,0,0,0,0,0,0,0,0,0,0,0,0,0,0
Jharkhand,6.2 - Other places related to work,2014,0,0,1,1,1,0,0,0,0,0,0,1,0,1,0,1,0,0,1,0,0,1,0,1,0,0,0,1,0,1,0
Jharkhand,6.3 - In Public Transport system,2014,0,0,0,0,0,0,0,0,0,0,0,0,0,0,0,0,0,0,0,0,0,0,0,0,0,0,0,0,0,0,0
Jharkhand,6.4 - in Other Places,2014,36,1,16,17,17,0,0,0,1,0,0,15,20,35,14,50,3,74,35,0,1,108,0,17,0,0,0,1,16,17,91
Jharkhand,7 - Cruelty by Husband or his Relatives (Section 498A),2014,962,723,739,1462,1462,0,0,0,33,70,5,643,448,1091,121,1320,1104,1538,1091,0,7,2622,55,615,33,105,138,71,406,477,1952
Jharkhand,8 - Importation of Girls from Foreign Country (Section 366B IPC),2014,0,1,1,2,2,0,0,0,0,0,0,2,0,2,0,2,0,5,2,0,0,7,0,0,0,0,0,0,0,0,7
Jharkhand,9 - Abetment of Suicides of Women u/s 306 IPC,2014,0,0,1,1,1,0,0,0,0,0,0,0,0,0,0,0,1,0,0,0,0,0,0,0,0,0,0,0,0,0,0
Jharkhand,"10 - Dowry Prohibition Act, 1961",2014,922,630,908,1538,1565,0,0,0,56,74,26,506,477,983,160,1299,1161,1243,983,0,17,2209,5,400,11,127,138,43,219,262,1804
Jharkhand,"11 - Indecent Representation of Women (Prohibition) Act, 1986",2014,3,0,2,2,2,0,0,0,0,0,0,0,0,0,3,3,2,4,0,0,0,4,0,0,0,0,0,0,0,0,4
Jharkhand,12 - Commission of Sati Prevention Act 1987,2014,0,0,0,0,0,0,0,0,0,0,0,0,0,0,0,0,0,0,0,0,0,0,0,0,0,0,0,0,0,0,0
Jharkhand,"13 - Protection of Women from Domestic Violence Act, 2005",2014,0,2,3,5,5,0,0,0,0,0,1,2,0,2,0,3,2,0,2,0,0,2,0,1,0,0,0,0,1,1,1
Jharkhand,14 - Immoral Traffic (Prevention) Act (Women Cases only),2014,1,0,11,11,11,0,0,0,0,1,0,4,0,4,1,6,6,0,4,0,0,4,0,0,0,0,0,0,0,0,4
Jharkhand,14.1 - Under ITP Section 5,2014,0,0,6,6,6,0,0,0,0,1,0,1,0,1,1,3,3,0,1,0,0,1,0,0,0,0,0,0,0,0,1
Jharkhand,14.2 - Under ITP Section 6,2014,0,0,1,1,1,0,0,0,0,0,0,1,0,1,0,1,0,0,1,0,0,1,0,0,0,0,0,0,0,0,1
Jharkhand,14.3 - Under ITP Section 7,2014,0,0,0,0,0,0,0,0,0,0,0,0,0,0,0,0,0,0,0,0,0,0,0,0,0,0,0,0,0,0,0
Jharkhand,14.4 - Under ITP Section 8,2014,1,0,0,0,0,0,0,0,0,0,0,0,0,0,0,0,1,0,0,0,0,0,0,0,0,0,0,0,0,0,0
Jharkhand,14.5 - Other Sections under ITP Act,2014,0,0,4,4,4,0,0,0,0,0,0,2,0,2,0,2,2,0,2,0,0,2,0,0,0,0,0,0,0,0,2
Jharkhand,15 - Total Crimes against Women,2014,3612,1710,4262,5972,6023,0,0,0,213,261,41,2620,1924,4544,525,5584,4000,7175,4544,0,30,11689,123,2515,194,591,785,298,1432,1730,9051
Karnataka,1 - Rape (Section 376 IPC),2014,376,11,1313,1324,1332,0,0,34,27,7,0,820,370,1190,3,1227,439,2078,1190,0,0,3268,1,415,0,72,72,29,314,343,2852
Karnataka,1.1 - Custodial Rape,2014,0,0,0,0,0,0,0,0,0,0,0,0,0,0,0,0,0,0,0,0,0,0,0,0,0,0,0,0,0,0,0
Karnataka,1.1.1 - Custodial_Gang Rape,2014,0,0,0,0,0,0,0,0,0,0,0,0,0,0,0,0,0,0,0,0,0,0,0,0,0,0,0,0,0,0,0
Karnataka,1.1.2 - Custodial_Other Rape,2014,0,0,0,0,0,0,0,0,0,0,0,0,0,0,0,0,0,0,0,0,0,0,0,0,0,0,0,0,0,0,0
Karnataka,1.2 - Rape other than Custodial,2014,376,11,1313,1324,1332,0,0,34,27,7,0,820,370,1190,3,1227,439,2078,1190,0,0,3268,1,415,0,72,72,29,314,343,2852
Karnataka,1.2.1 - Rape_Gang Rape,2014,0,0,25,25,25,0,0,1,0,0,0,13,2,15,0,15,9,2,15,0,0,17,0,0,0,0,0,0,0,0,17
Karnataka,1.2.2 - Rape_Others,2014,376,11,1288,1299,1307,0,0,33,27,7,0,807,368,1175,3,1212,430,2076,1175,0,0,3251,1,415,0,72,72,29,314,343,2835
Karnataka,2 - Attempt to commit Rape (Section 376 & 511 IPC),2014,0,1,21,22,22,0,0,0,5,0,0,13,0,13,0,18,4,3,13,0,0,16,0,1,0,0,0,0,1,1,15
Karnataka,"3 - Kidnapping & Abduction of Women (Section 363,364,364A, 366-369 IPC)",2014,501,7,1450,1457,1512,0,0,18,569,209,0,304,187,491,23,1292,648,941,491,0,0,1432,4,172,1,6,7,3,162,165,1256
Karnataka,3.1 - Kidnaping & Abduction Section 363 IPC,2014,271,0,769,769,782,0,0,14,389,143,0,121,59,180,14,726,300,405,180,0,0,585,2,60,1,2,3,2,55,57,523
Karnataka,3.2 - Kidnaping & Abduction in order to Murder Section 364 IPC,2014,0,0,0,0,0,0,0,0,0,0,0,0,0,0,0,0,0,0,0,0,0,0,0,0,0,0,0,0,0,0,0
Karnataka,3.3 - Kidnapping for Ransom Section 364A,2014,0,0,8,8,8,0,0,0,1,0,0,6,0,6,0,7,1,0,6,0,0,6,0,0,0,0,0,0,0,0,6
Karnataka,3.4 - Kidnapping & Abduction of Women to compel her for marriage,2014,152,1,209,210,213,0,0,2,82,30,0,41,87,128,2,242,118,351,128,0,0,479,0,60,0,3,3,0,57,57,419
Karnataka,3.5 - Kidnapping & Abduction of Women-Other,2014,78,6,464,470,509,0,0,2,97,36,0,136,41,177,7,317,229,185,177,0,0,362,2,52,0,1,1,1,50,51,308
Karnataka,4 - Dowry Deaths (Section 304-B IPC),2014,95,3,310,313,314,0,0,8,12,0,0,219,76,295,4,311,89,845,295,0,0,1140,2,136,0,13,13,0,123,123,1002
Karnataka,5 - Assault on Women with intent to outrage her Modesty_Total (Section 354 IPC),2014,1186,92,5171,5263,5334,0,0,29,204,85,0,3455,1103,4558,25,4872,1548,7880,4558,0,3,12435,115,1937,19,77,96,81,1760,1841,10383
Karnataka,5.1 - Sexual Harassment,2014,56,3,250,253,258,0,0,7,11,4,0,154,40,194,1,210,92,204,194,0,0,398,2,24,0,0,0,0,24,24,372
Karnataka,5.2 - Assault on women with intent to Disrobe,2014,2,0,163,163,163,0,0,1,8,0,0,92,2,94,1,103,61,7,94,0,0,101,0,9,0,0,0,1,8,9,92
Karnataka,5.3 - Voyeurism,2014,0,0,8,8,8,0,0,0,0,0,0,6,0,6,1,7,1,0,6,0,0,6,0,0,0,0,0,0,0,0,6
Karnataka,5.4 - Stalking,2014,2,0,64,64,64,0,0,1,1,2,0,37,3,40,1,44,21,0,40,0,1,39,0,1,0,0,0,0,1,1,38
Karnataka,5.5 - Others,2014,1126,89,4686,4775,4841,0,0,20,184,79,0,3166,1058,4224,21,4508,1373,7669,4224,0,2,11891,113,1903,19,77,96,80,1727,1807,9875
Karnataka,6 - Insult to the Modesty of Women_Total (Section 509 IPC),2014,38,3,167,170,170,0,0,1,9,2,0,115,31,146,7,164,43,137,146,0,0,283,17,58,2,2,4,6,48,54,208
Karnataka,6.1 - At Office premises,2014,1,0,3,3,3,0,0,0,0,0,0,2,1,3,0,3,1,1,3,0,0,4,0,0,0,0,0,0,0,0,4
Karnataka,6.2 - Other places related to work,2014,1,0,9,9,9,0,0,0,0,0,0,6,1,7,0,7,3,5,7,0,0,12,0,2,0,0,0,0,2,2,10
Karnataka,6.3 - In Public Transport system,2014,1,0,1,1,1,0,0,1,0,0,0,0,1,1,0,1,0,2,1,0,0,3,0,1,0,0,0,0,1,1,2
Karnataka,6.4 - in Other Places,2014,35,3,154,157,157,0,0,0,9,2,0,107,28,135,7,153,39,129,135,0,0,264,17,55,2,2,4,6,45,51,192
Karnataka,7 - Cruelty by Husband or his Relatives (Section 498A),2014,1026,128,2897,3025,3044,0,1,56,179,67,0,1828,782,2610,29,2885,1109,9535,2610,0,3,12142,118,1940,11,59,70,98,1772,1870,10084
Karnataka,8 - Importation of Girls from Foreign Country (Section 366B IPC),2014,0,0,0,0,0,0,0,0,0,0,0,0,0,0,0,0,0,0,0,0,0,0,0,0,0,0,0,0,0,0,0
Karnataka,9 - Abetment of Suicides of Women u/s 306 IPC,2014,5,0,222,222,228,0,0,1,14,0,0,134,3,137,0,151,75,29,137,0,0,166,0,10,0,0,0,0,10,10,156
Karnataka,"10 - Dowry Prohibition Act, 1961",2014,865,112,1618,1730,1732,1,0,63,109,30,0,845,618,1463,12,1614,917,3474,1463,0,0,4937,42,523,4,12,16,12,495,507,4372
Karnataka,"11 - Indecent Representation of Women (Prohibition) Act, 1986",2014,3,0,0,0,0,0,0,0,1,0,0,0,1,1,0,2,1,0,1,0,0,1,0,0,0,0,0,0,0,0,1
Karnataka,12 - Commission of Sati Prevention Act 1987,2014,0,0,0,0,0,0,0,0,0,0,0,0,0,0,0,0,0,0,0,0,0,0,0,0,0,0,0,0,0,0,0
Karnataka,"13 - Protection of Women from Domestic Violence Act, 2005",2014,0,0,0,0,0,0,0,0,0,0,0,0,0,0,0,0,0,0,0,0,0,0,0,0,0,0,0,0,0,0,0
Karnataka,14 - Immoral Traffic (Prevention) Act (Women Cases only),2014,97,0,388,388,566,0,0,1,0,0,0,297,63,360,0,360,124,1103,360,0,0,1463,0,190,26,50,76,1,113,114,1273
Karnataka,14.1 - Under ITP Section 5,2014,29,0,104,104,196,0,0,0,0,0,0,75,19,94,0,94,39,319,94,0,0,413,0,55,0,6,6,1,48,49,358
Karnataka,14.2 - Under ITP Section 6,2014,0,0,4,4,5,0,0,0,0,0,0,0,0,0,0,0,4,0,0,0,0,0,0,0,0,0,0,0,0,0,0
Karnataka,14.3 - Under ITP Section 7,2014,3,0,39,39,40,0,0,0,0,0,0,27,3,30,0,30,12,66,30,0,0,96,0,4,0,4,4,0,0,0,92
Karnataka,14.4 - Under ITP Section 8,2014,3,0,21,21,27,0,0,0,0,0,0,20,3,23,0,23,1,58,23,0,0,81,0,22,5,13,18,0,4,4,59
Karnataka,14.5 - Other Sections under ITP Act,2014,62,0,220,220,298,0,0,1,0,0,0,175,38,213,0,213,68,660,213,0,0,873,0,109,21,27,48,0,61,61,764
Karnataka,15 - Total Crimes against Women,2014,4192,357,13557,13914,14254,1,1,211,1129,400,0,8030,3234,11264,103,12896,4997,26025,11264,0,6,37283,299,5382,63,291,354,230,4798,5028,31602
Kerala,1 - Rape (Section 376 IPC),2014,972,39,1308,1347,1357,0,0,51,37,8,0,594,561,1155,37,1237,1031,5648,1155,0,1,6802,3,401,0,103,103,2,296,298,6398
Kerala,1.1 - Custodial Rape,2014,0,0,0,0,0,0,0,0,0,0,0,0,0,0,0,0,0,1,0,0,0,1,0,0,0,0,0,0,0,0,1
Kerala,1.1.1 - Custodial_Gang Rape,2014,0,0,0,0,0,0,0,0,0,0,0,0,0,0,0,0,0,0,0,0,0,0,0,0,0,0,0,0,0,0,0
Kerala,1.1.2 - Custodial_Other Rape,2014,0,0,0,0,0,0,0,0,0,0,0,0,0,0,0,0,0,1,0,0,0,1,0,0,0,0,0,0,0,0,1
Kerala,1.2 - Rape other than Custodial,2014,972,39,1308,1347,1357,0,0,51,37,8,0,594,561,1155,37,1237,1031,5647,1155,0,1,6801,3,401,0,103,103,2,296,298,6397
Kerala,1.2.1 - Rape_Gang Rape,2014,14,0,8,8,9,0,0,0,0,0,0,2,5,7,1,8,14,48,7,0,0,55,0,3,0,0,0,0,3,3,52
Kerala,1.2.2 - Rape_Others,2014,958,39,1300,1339,1348,0,0,51,37,8,0,592,556,1148,36,1229,1017,5599,1148,0,1,6746,3,398,0,103,103,2,293,295,6345
Kerala,2 - Attempt to commit Rape (Section 376 & 511 IPC),2014,16,0,36,36,36,0,0,1,1,0,0,24,12,36,1,38,13,85,36,0,0,121,0,12,0,3,3,0,9,9,109
Kerala,"3 - Kidnapping & Abduction of Women (Section 363,364,364A, 366-369 IPC)",2014,108,0,143,143,145,0,0,1,4,1,0,89,46,135,7,147,103,899,135,0,10,1024,2,42,0,0,0,0,42,42,980
Kerala,3.1 - Kidnaping & Abduction Section 363 IPC,2014,1,0,24,24,24,0,0,0,0,0,0,13,4,17,1,18,7,65,17,0,0,82,0,4,0,0,0,0,4,4,78
Kerala,3.2 - Kidnaping & Abduction in order to Murder Section 364 IPC,2014,0,0,0,0,0,0,0,0,0,0,0,0,0,0,0,0,0,0,0,0,0,0,0,0,0,0,0,0,0,0,0
Kerala,3.3 - Kidnapping for Ransom Section 364A,2014,0,0,0,0,0,0,0,0,0,0,0,0,0,0,0,0,0,1,0,0,0,1,0,0,0,0,0,0,0,0,1
Kerala,3.4 - Kidnapping & Abduction of Women to compel her for marriage,2014,93,0,89,89,90,0,0,1,3,0,0,55,35,90,6,99,82,721,90,0,10,801,0,31,0,0,0,0,31,31,770
Kerala,3.5 - Kidnapping & Abduction of Women-Other,2014,14,0,30,30,31,0,0,0,1,1,0,21,7,28,0,30,14,112,28,0,0,140,2,7,0,0,0,0,7,7,131
Kerala,4 - Dowry Deaths (Section 304-B IPC),2014,25,0,28,28,28,0,0,0,2,0,0,9,12,21,1,24,29,197,21,0,0,218,2,6,0,0,0,0,6,6,210
Kerala,5 - Assault on Women with intent to outrage her Modesty_Total (Section 354 IPC),2014,993,172,4195,4367,4412,0,0,32,198,43,0,3113,721,3834,90,4165,1163,16274,3834,1,69,20038,100,1902,23,199,222,55,1625,1680,18036
Kerala,5.1 - Sexual Harassment,2014,191,16,964,980,997,0,0,6,28,10,0,696,92,788,29,855,310,2716,788,0,69,3435,11,182,5,33,38,7,137,144,3242
Kerala,5.2 - Assault on women with intent to Disrobe,2014,31,30,368,398,404,0,0,0,12,5,0,334,27,361,6,384,45,1019,361,0,0,1380,54,219,0,26,26,4,189,193,1107
Kerala,5.3 - Voyeurism,2014,1,0,18,18,18,0,0,0,0,0,0,16,0,16,0,16,3,2,16,0,0,18,0,1,0,0,0,0,1,1,17
Kerala,5.4 - Stalking,2014,1,0,37,37,37,0,0,0,0,0,0,29,1,30,0,30,8,8,30,0,0,38,0,2,0,0,0,0,2,2,36
Kerala,5.5 - Others,2014,769,126,2808,2934,2956,0,0,26,158,28,0,2038,601,2639,55,2880,797,12529,2639,1,0,15167,35,1498,18,140,158,44,1296,1340,13634
Kerala,6 - Insult to the Modesty of Women_Total (Section 509 IPC),2014,42,5,252,257,261,0,0,1,3,1,0,214,30,244,9,257,41,1654,244,0,14,1884,8,217,4,47,51,0,166,166,1659
Kerala,6.1 - At Office premises,2014,0,0,6,6,6,0,0,0,0,0,0,6,0,6,0,6,0,25,6,0,0,31,0,2,0,0,0,0,2,2,29
Kerala,6.2 - Other places related to work,2014,0,0,3,3,3,0,0,0,0,0,0,3,0,3,0,3,0,36,3,0,0,39,0,4,0,0,0,0,4,4,35
Kerala,6.3 - In Public Transport system,2014,1,0,11,11,11,0,0,0,0,0,0,9,1,10,1,11,1,40,10,0,0,50,0,9,2,2,4,0,5,5,41
Kerala,6.4 - in Other Places,2014,41,5,232,237,241,0,0,1,3,1,0,196,29,225,8,237,40,1553,225,0,14,1764,8,202,2,45,47,0,155,155,1554
Kerala,7 - Cruelty by Husband or his Relatives (Section 498A),2014,1539,1530,3389,4919,4926,0,0,110,109,50,0,3331,1127,4458,156,4773,1575,22608,4458,0,4,27062,57,2915,10,122,132,47,2736,2783,24090
Kerala,8 - Importation of Girls from Foreign Country (Section 366B IPC),2014,0,0,0,0,0,0,0,0,0,0,0,0,0,0,0,0,0,0,0,0,0,0,0,0,0,0,0,0,0,0,0
Kerala,9 - Abetment of Suicides of Women u/s 306 IPC,2014,26,0,38,38,38,0,0,0,0,0,0,15,13,28,0,28,36,61,28,0,0,89,0,2,0,0,0,1,1,2,87
Kerala,"10 - Dowry Prohibition Act, 1961",2014,4,0,3,3,3,0,0,0,0,1,0,2,1,3,0,4,3,23,3,0,0,26,0,0,0,0,0,0,0,0,26
Kerala,"11 - Indecent Representation of Women (Prohibition) Act, 1986",2014,10,0,11,11,11,0,0,0,1,0,0,8,4,12,0,13,8,104,12,0,0,116,0,2,0,0,0,0,2,2,114
Kerala,12 - Commission of Sati Prevention Act 1987,2014,0,0,0,0,0,0,0,0,0,0,0,0,0,0,0,0,0,0,0,0,0,0,0,0,0,0,0,0,0,0,0
Kerala,"13 - Protection of Women from Domestic Violence Act, 2005",2014,22,24,116,140,140,0,0,2,7,3,0,92,14,106,9,125,35,112,106,0,2,216,5,16,1,1,2,0,14,14,195
Kerala,14 - Immoral Traffic (Prevention) Act (Women Cases only),2014,8,0,91,91,102,0,0,0,2,2,0,80,6,86,0,90,9,387,86,0,0,473,0,67,25,11,36,0,31,31,406
Kerala,14.1 - Under ITP Section 5,2014,1,0,4,4,4,0,0,0,0,0,0,4,1,5,0,5,0,12,5,0,0,17,0,6,0,0,0,0,6,6,11
Kerala,14.2 - Under ITP Section 6,2014,0,0,0,0,0,0,0,0,0,0,0,0,0,0,0,0,0,4,0,0,0,4,0,1,0,0,0,0,1,1,3
Kerala,14.3 - Under ITP Section 7,2014,5,0,28,28,28,0,0,0,0,0,0,25,5,30,0,30,3,67,30,0,0,97,0,12,1,1,2,0,10,10,85
Kerala,14.4 - Under ITP Section 8,2014,0,0,48,48,52,0,0,0,2,0,0,46,0,46,0,48,0,243,46,0,0,289,0,37,24,8,32,0,5,5,252
Kerala,14.5 - Other Sections under ITP Act,2014,2,0,11,11,18,0,0,0,0,2,0,5,0,5,0,7,6,61,5,0,0,66,0,11,0,2,2,0,9,9,55
Kerala,15 - Total Crimes against Women,2014,3765,1770,9610,11380,11459,0,0,198,364,109,0,7571,2547,10118,310,10901,4046,48052,10118,1,100,58069,177,5582,63,486,549,105,4928,5033,52310
Madhya Pradesh,1 - Rape (Section 376 IPC),2014,368,0,5076,5076,5085,0,0,1,34,28,1,4611,349,4960,11,5034,409,8042,4960,0,20,12982,29,3794,340,891,1231,562,2001,2563,9159
Madhya Pradesh,1.1 - Custodial Rape,2014,0,0,0,0,0,0,0,0,0,0,0,0,0,0,0,0,0,1,0,0,0,1,0,1,0,1,1,0,0,0,0
Madhya Pradesh,1.1.1 - Custodial_Gang Rape,2014,0,0,0,0,0,0,0,0,0,0,0,0,0,0,0,0,0,1,0,0,0,1,0,1,0,1,1,0,0,0,0
Madhya Pradesh,1.1.2 - Custodial_Other Rape,2014,0,0,0,0,0,0,0,0,0,0,0,0,0,0,0,0,0,0,0,0,0,0,0,0,0,0,0,0,0,0,0
Madhya Pradesh,1.2 - Rape other than Custodial,2014,368,0,5076,5076,5085,0,0,1,34,28,1,4611,349,4960,11,5034,409,8041,4960,0,20,12981,29,3793,340,890,1230,562,2001,2563,9159
Madhya Pradesh,1.2.1 - Rape_Gang Rape,2014,3,0,284,284,285,0,0,0,2,2,0,245,13,258,0,262,25,139,258,0,0,397,0,93,10,27,37,21,35,56,304
Madhya Pradesh,1.2.2 - Rape_Others,2014,365,0,4792,4792,4800,0,0,1,32,26,1,4366,336,4702,11,4772,384,7902,4702,0,20,12584,29,3700,330,863,1193,541,1966,2507,8855
Madhya Pradesh,2 - Attempt to commit Rape (Section 376 & 511 IPC),2014,0,0,56,56,56,0,0,0,1,0,0,53,0,53,0,54,2,0,53,0,0,53,0,7,1,0,1,5,1,6,46
Madhya Pradesh,"3 - Kidnapping & Abduction of Women (Section 363,364,364A, 366-369 IPC)",2014,1676,1,5687,5688,5738,0,0,1,848,665,99,1765,812,2577,348,4537,2826,2993,2577,0,0,5570,14,901,58,210,268,180,453,633,4655
Madhya Pradesh,3.1 - Kidnaping & Abduction Section 363 IPC,2014,528,0,2233,2233,2248,0,0,0,380,174,6,591,192,783,222,1565,1196,694,783,0,0,1477,0,335,29,74,103,70,162,232,1142
Madhya Pradesh,3.2 - Kidnaping & Abduction in order to Murder Section 364 IPC,2014,3,0,9,9,9,0,0,0,1,1,0,6,3,9,0,11,1,4,9,0,0,13,0,2,0,2,2,0,0,0,11
Madhya Pradesh,3.3 - Kidnapping for Ransom Section 364A,2014,0,0,2,2,2,0,0,0,0,0,0,2,0,2,0,2,0,0,2,0,0,2,0,0,0,0,0,0,0,0,2
Madhya Pradesh,3.4 - Kidnapping & Abduction of Women to compel her for marriage,2014,832,1,2363,2364,2364,0,0,0,318,317,58,765,482,1247,93,2033,1163,1647,1247,0,0,2894,14,390,22,66,88,75,227,302,2490
Madhya Pradesh,3.5 - Kidnapping & Abduction of Women-Other,2014,313,0,1080,1080,1115,0,0,1,149,173,35,401,135,536,33,926,466,648,536,0,0,1184,0,174,7,68,75,35,64,99,1010
Madhya Pradesh,4 - Dowry Deaths (Section 304-B IPC),2014,91,1,732,733,737,0,0,0,0,0,0,656,77,733,1,734,90,2403,733,0,3,3133,0,684,52,264,316,26,342,368,2449
Madhya Pradesh,5 - Assault on Women with intent to outrage her Modesty_Total (Section 354 IPC),2014,462,0,9609,9609,9618,0,0,2,29,33,4,9206,448,9654,16,9736,333,24555,9654,0,802,33407,1667,5467,545,2184,2729,616,2122,2738,26273
Madhya Pradesh,5.1 - Sexual Harassment,2014,276,0,3163,3163,3165,0,0,0,10,7,2,3056,271,3327,3,3349,90,7382,3327,0,162,10547,877,1301,208,365,573,299,429,728,8369
Madhya Pradesh,5.2 - Assault on women with intent to Disrobe,2014,2,0,132,132,132,0,0,0,0,1,0,125,2,127,0,128,6,1,127,0,0,128,1,4,2,0,2,2,0,2,123
Madhya Pradesh,5.3 - Voyeurism,2014,5,0,86,86,86,0,0,0,0,0,0,85,5,90,0,90,1,8,90,0,2,96,1,1,0,0,0,0,1,1,94
Madhya Pradesh,5.4 - Stalking,2014,2,0,401,401,401,0,0,0,1,1,1,385,1,386,1,390,13,42,386,0,14,414,1,32,13,4,17,14,1,15,381
Madhya Pradesh,5.5 - Others,2014,177,0,5827,5827,5834,0,0,2,18,24,1,5555,169,5724,12,5779,223,17122,5724,0,624,22222,787,4129,322,1815,2137,301,1691,1992,17306
Madhya Pradesh,6 - Insult to the Modesty of Women_Total (Section 509 IPC),2014,39,0,429,429,429,0,0,0,1,5,0,402,33,435,4,445,23,1775,435,4,51,2155,61,310,28,118,146,17,147,164,1784
Madhya Pradesh,6.1 - At Office premises,2014,0,0,1,1,1,0,0,0,0,0,0,1,0,1,0,1,0,0,1,0,0,1,0,0,0,0,0,0,0,0,1
Madhya Pradesh,6.2 - Other places related to work,2014,20,0,21,21,21,0,0,0,0,0,0,21,20,41,0,41,0,130,41,0,1,170,4,15,0,6,6,0,9,9,151
Madhya Pradesh,6.3 - In Public Transport system,2014,0,0,3,3,3,0,0,0,0,0,0,3,0,3,0,3,0,13,3,0,0,16,0,0,0,0,0,0,0,0,16
Madhya Pradesh,6.4 - in Other Places,2014,19,0,404,404,404,0,0,0,1,5,0,377,13,390,4,400,23,1632,390,4,50,1968,57,295,28,112,140,17,138,155,1616
Madhya Pradesh,7 - Cruelty by Husband or his Relatives (Section 498A),2014,230,0,6451,6451,6462,0,0,2,5,11,0,6220,219,6439,0,6455,224,13060,6439,0,763,18736,834,2816,72,967,1039,194,1583,1777,15086
Madhya Pradesh,8 - Importation of Girls from Foreign Country (Section 366B IPC),2014,1,0,0,0,0,0,0,0,0,0,0,0,1,1,0,1,0,42,1,0,0,43,0,7,0,1,1,0,6,6,36
Madhya Pradesh,9 - Abetment of Suicides of Women u/s 306 IPC,2014,12,0,455,455,456,0,0,0,2,0,0,413,11,424,1,427,40,152,424,0,0,576,0,46,6,11,17,13,16,29,530
Madhya Pradesh,"10 - Dowry Prohibition Act, 1961",2014,3,0,113,113,113,0,0,0,0,0,0,113,2,115,0,115,1,310,115,0,0,425,7,56,1,12,13,8,35,43,362
Madhya Pradesh,"11 - Indecent Representation of Women (Prohibition) Act, 1986",2014,0,0,0,0,0,0,0,0,0,0,0,0,0,0,0,0,0,0,0,0,0,0,0,0,0,0,0,0,0,0,0
Madhya Pradesh,12 - Commission of Sati Prevention Act 1987,2014,0,0,0,0,0,0,0,0,0,0,0,0,0,0,0,0,0,0,0,0,0,0,0,0,0,0,0,0,0,0,0
Madhya Pradesh,"13 - Protection of Women from Domestic Violence Act, 2005",2014,0,49,4,53,53,0,0,0,0,0,0,51,0,51,0,51,2,0,51,0,0,51,0,18,2,0,2,16,0,16,33
Madhya Pradesh,14 - Immoral Traffic (Prevention) Act (Women Cases only),2014,1,0,15,15,16,0,0,0,0,0,0,12,1,13,0,13,3,41,13,0,0,54,0,8,0,8,8,0,0,0,46
Madhya Pradesh,14.1 - Under ITP Section 5,2014,0,0,2,2,2,0,0,0,0,0,0,2,0,2,0,2,0,0,2,0,0,2,0,0,0,0,0,0,0,0,2
Madhya Pradesh,14.2 - Under ITP Section 6,2014,0,0,0,0,0,0,0,0,0,0,0,0,0,0,0,0,0,0,0,0,0,0,0,0,0,0,0,0,0,0,0
Madhya Pradesh,14.3 - Under ITP Section 7,2014,0,0,2,2,3,0,0,0,0,0,0,2,0,2,0,2,0,4,2,0,0,6,0,0,0,0,0,0,0,0,6
Madhya Pradesh,14.4 - Under ITP Section 8,2014,0,0,0,0,0,0,0,0,0,0,0,0,0,0,0,0,0,0,0,0,0,0,0,0,0,0,0,0,0,0,0
Madhya Pradesh,14.5 - Other Sections under ITP Act,2014,1,0,11,11,11,0,0,0,0,0,0,8,1,9,0,9,3,37,9,0,0,46,0,8,0,8,8,0,0,0,38
Madhya Pradesh,15 - Total Crimes against Women,2014,2883,51,28627,28678,28763,0,0,6,920,742,104,23502,1953,25455,381,27602,3953,53373,25455,4,1639,77185,2612,14114,1105,4666,5771,1637,6706,8343,60459
Maharashtra,1 - Rape (Section 376 IPC),2014,1195,37,3401,3438,3463,0,1,2,38,24,6,2035,989,3024,31,3123,1507,14909,3024,1,1,17931,25,1058,16,186,202,51,805,856,16848
Maharashtra,1.1 - Custodial Rape,2014,0,0,0,0,0,0,0,0,0,0,0,0,0,0,0,0,0,0,0,0,0,0,0,0,0,0,0,0,0,0,0
Maharashtra,1.1.1 - Custodial_Gang Rape,2014,0,0,0,0,0,0,0,0,0,0,0,0,0,0,0,0,0,0,0,0,0,0,0,0,0,0,0,0,0,0,0
Maharashtra,1.1.2 - Custodial_Other Rape,2014,0,0,0,0,0,0,0,0,0,0,0,0,0,0,0,0,0,0,0,0,0,0,0,0,0,0,0,0,0,0,0
Maharashtra,1.2 - Rape other than Custodial,2014,1195,37,3401,3438,3463,0,1,2,38,24,6,2035,989,3024,31,3123,1507,14909,3024,1,1,17931,25,1058,16,186,202,51,805,856,16848
Maharashtra,1.2.1 - Rape_Gang Rape,2014,26,2,124,126,127,0,0,0,4,0,0,80,21,101,0,105,47,197,101,0,0,298,0,20,0,4,4,1,15,16,278
Maharashtra,1.2.2 - Rape_Others,2014,1169,35,3277,3312,3336,0,1,2,34,24,6,1955,968,2923,31,3018,1460,14712,2923,1,1,17633,25,1038,16,182,198,50,790,840,16570
Maharashtra,2 - Attempt to commit Rape (Section 376 & 511 IPC),2014,4,0,15,15,15,0,0,0,0,0,0,8,4,12,0,12,7,25,12,0,0,37,0,2,0,0,0,0,2,2,35
Maharashtra,"3 - Kidnapping & Abduction of Women (Section 363,364,364A, 366-369 IPC)",2014,1065,15,2442,2457,2583,0,0,2,126,469,21,529,496,1025,121,1762,1758,7370,1025,0,0,8395,13,427,2,14,16,19,392,411,7955
Maharashtra,3.1 - Kidnaping & Abduction Section 363 IPC,2014,371,1,1041,1042,1092,0,0,1,61,183,3,166,127,293,56,596,816,2168,293,0,0,2461,5,98,2,7,9,7,82,89,2358
Maharashtra,3.2 - Kidnaping & Abduction in order to Murder Section 364 IPC,2014,6,0,1,1,1,0,0,0,0,1,0,0,0,0,3,4,3,21,0,0,0,21,0,1,0,0,0,0,1,1,20
Maharashtra,3.3 - Kidnapping for Ransom Section 364A,2014,2,0,8,8,8,0,0,0,0,0,0,4,1,5,0,5,5,110,5,0,0,115,0,2,0,0,0,0,2,2,113
Maharashtra,3.4 - Kidnapping & Abduction of Women to compel her for marriage,2014,498,12,1034,1046,1072,0,0,1,51,192,16,276,291,567,32,858,685,3587,567,0,0,4154,8,261,0,7,7,9,245,254,3885
Maharashtra,3.5 - Kidnapping & Abduction of Women-Other,2014,188,2,358,360,410,0,0,0,14,93,2,83,77,160,30,299,249,1484,160,0,0,1644,0,65,0,0,0,3,62,65,1579
Maharashtra,4 - Dowry Deaths (Section 304-B IPC),2014,100,0,279,279,279,0,0,0,0,1,1,163,103,266,1,269,110,3877,266,0,0,4143,3,198,0,19,19,1,178,179,3942
Maharashtra,5 - Assault on Women with intent to outrage her Modesty_Total (Section 354 IPC),2014,3147,88,9913,10001,10038,2,1,4,126,48,66,6115,2349,8464,200,8904,4237,31694,8464,1,2,40155,336,2722,37,357,394,119,2209,2328,37097
Maharashtra,5.1 - Sexual Harassment,2014,761,33,4019,4052,4065,1,1,2,40,12,15,2487,569,3056,46,3169,1640,5353,3056,0,1,8408,43,554,14,52,66,44,444,488,7811
Maharashtra,5.2 - Assault on women with intent to Disrobe,2014,53,7,302,309,310,0,0,0,2,1,0,185,48,233,2,238,124,193,233,0,0,426,5,13,0,1,1,4,8,12,408
Maharashtra,5.3 - Voyeurism,2014,18,2,103,105,105,0,0,0,2,1,0,59,8,67,0,70,53,87,67,0,0,154,0,4,0,1,1,0,3,3,150
Maharashtra,5.4 - Stalking,2014,52,0,797,797,797,0,0,2,2,3,1,489,52,541,10,557,290,570,541,0,0,1111,1,19,0,1,1,6,12,18,1091
Maharashtra,5.5 - Others,2014,2263,46,4692,4738,4761,1,0,0,80,31,50,2895,1672,4567,142,4870,2130,25491,4567,1,1,30056,287,2132,23,302,325,65,1742,1807,27637
Maharashtra,6 - Insult to the Modesty of Women_Total (Section 509 IPC),2014,1111,1,1574,1575,1582,0,0,0,7,5,5,1015,607,1622,31,1670,1016,10026,1622,0,2,11646,123,636,3,48,51,12,573,585,10887
Maharashtra,6.1 - At Office premises,2014,2,0,10,10,10,0,0,0,0,0,0,4,4,8,0,8,4,19,8,0,0,27,0,0,0,0,0,0,0,0,27
Maharashtra,6.2 - Other places related to work,2014,18,0,48,48,48,0,0,0,0,1,0,29,11,40,3,44,22,360,40,0,0,400,2,11,1,0,1,0,10,10,387
Maharashtra,6.3 - In Public Transport system,2014,9,0,8,8,8,0,0,0,0,0,0,8,4,12,1,13,4,64,12,0,0,76,0,3,0,0,0,0,3,3,73
Maharashtra,6.4 - in Other Places,2014,1082,1,1508,1509,1516,0,0,0,7,4,5,974,588,1562,27,1605,986,9583,1562,0,2,11143,121,622,2,48,50,12,560,572,10400
Maharashtra,7 - Cruelty by Husband or his Relatives (Section 498A),2014,3188,407,7289,7696,7696,2,0,5,49,90,21,4608,2907,7515,111,7786,3091,55595,7515,7,6,63097,985,4738,1,112,113,109,4516,4625,57374
Maharashtra,8 - Importation of Girls from Foreign Country (Section 366B IPC),2014,0,0,1,1,1,0,0,0,0,0,0,1,0,1,0,1,0,0,1,0,0,1,0,0,0,0,0,0,0,0,1
Maharashtra,9 - Abetment of Suicides of Women u/s 306 IPC,2014,187,2,984,986,986,0,0,0,0,0,2,426,201,627,9,638,535,4999,627,0,0,5626,1,564,28,46,74,10,480,490,5061
Maharashtra,"10 - Dowry Prohibition Act, 1961",2014,10,0,39,39,39,0,0,0,0,0,0,25,10,35,0,35,14,314,35,0,0,349,4,35,0,14,14,0,21,21,310
Maharashtra,"11 - Indecent Representation of Women (Prohibition) Act, 1986",2014,0,0,0,0,0,0,0,0,0,0,0,0,0,0,0,0,0,57,0,0,0,57,0,1,0,0,0,0,1,1,56
Maharashtra,12 - Commission of Sati Prevention Act 1987,2014,0,0,0,0,0,0,0,0,0,0,0,0,0,0,0,0,0,0,0,0,0,0,0,0,0,0,0,0,0,0,0
Maharashtra,"13 - Protection of Women from Domestic Violence Act, 2005",2014,3,0,4,4,4,0,0,0,0,0,0,2,1,3,0,3,4,18,3,0,0,21,0,0,0,0,0,0,0,0,21
Maharashtra,14 - Immoral Traffic (Prevention) Act (Women Cases only),2014,90,0,202,202,327,0,0,0,0,0,0,120,61,181,3,184,108,994,181,0,0,1175,2,64,18,22,40,1,23,24,1109
Maharashtra,14.1 - Under ITP Section 5,2014,44,0,79,79,149,0,0,0,0,0,0,42,29,71,3,74,49,264,71,0,0,335,2,9,1,2,3,0,6,6,324
Maharashtra,14.2 - Under ITP Section 6,2014,2,0,5,5,22,0,0,0,0,0,0,2,2,4,0,4,3,10,4,0,0,14,0,1,0,0,0,0,1,1,13
Maharashtra,14.3 - Under ITP Section 7,2014,14,0,33,33,50,0,0,0,0,0,0,19,12,31,0,31,16,278,31,0,0,309,0,8,0,2,2,1,5,6,301
Maharashtra,14.4 - Under ITP Section 8,2014,0,0,7,7,7,0,0,0,0,0,0,5,0,5,0,5,2,33,5,0,0,38,0,1,0,0,0,0,1,1,37
Maharashtra,14.5 - Other Sections under ITP Act,2014,30,0,78,78,99,0,0,0,0,0,0,52,18,70,0,70,38,409,70,0,0,479,0,45,17,18,35,0,10,10,434
Maharashtra,15 - Total Crimes against Women,2014,10100,550,26143,26693,27013,4,2,13,346,637,122,15047,7728,22775,507,24387,12387,129878,22775,9,11,152633,1492,10445,105,818,923,322,9200,9522,140696
Manipur,1 - Rape (Section 376 IPC),2014,268,0,75,75,75,0,0,0,0,0,0,20,21,41,15,56,287,85,41,0,0,126,0,7,1,2,3,0,4,4,119
Manipur,1.1 - Custodial Rape,2014,0,0,0,0,0,0,0,0,0,0,0,0,0,0,0,0,0,0,0,0,0,0,0,0,0,0,0,0,0,0,0
Manipur,1.1.1 - Custodial_Gang Rape,2014,0,0,0,0,0,0,0,0,0,0,0,0,0,0,0,0,0,0,0,0,0,0,0,0,0,0,0,0,0,0,0
Manipur,1.1.2 - Custodial_Other Rape,2014,0,0,0,0,0,0,0,0,0,0,0,0,0,0,0,0,0,0,0,0,0,0,0,0,0,0,0,0,0,0,0
Manipur,1.2 - Rape other than Custodial,2014,268,0,75,75,75,0,0,0,0,0,0,20,21,41,15,56,287,85,41,0,0,126,0,7,1,2,3,0,4,4,119
Manipur,1.2.1 - Rape_Gang Rape,2014,0,0,0,0,0,0,0,0,0,0,0,0,0,0,0,0,0,0,0,0,0,0,0,0,0,0,0,0,0,0,0
Manipur,1.2.2 - Rape_Others,2014,268,0,75,75,75,0,0,0,0,0,0,20,21,41,15,56,287,85,41,0,0,126,0,7,1,2,3,0,4,4,119
Manipur,2 - Attempt to commit Rape (Section 376 & 511 IPC),2014,0,0,1,1,1,0,0,0,0,0,0,0,0,0,0,0,1,0,0,0,0,0,0,0,0,0,0,0,0,0,0
Manipur,"3 - Kidnapping & Abduction of Women (Section 363,364,364A, 366-369 IPC)",2014,488,0,121,121,128,0,0,0,0,0,0,8,2,10,64,74,535,22,10,0,0,32,1,4,0,1,1,0,3,3,27
Manipur,3.1 - Kidnaping & Abduction Section 363 IPC,2014,0,0,2,2,2,0,0,0,0,0,0,0,0,0,0,0,2,0,0,0,0,0,0,0,0,0,0,0,0,0,0
Manipur,3.2 - Kidnaping & Abduction in order to Murder Section 364 IPC,2014,0,0,0,0,0,0,0,0,0,0,0,0,0,0,0,0,0,0,0,0,0,0,0,0,0,0,0,0,0,0,0
Manipur,3.3 - Kidnapping for Ransom Section 364A,2014,0,0,5,5,5,0,0,0,0,0,0,0,0,0,0,0,5,0,0,0,0,0,0,0,0,0,0,0,0,0,0
Manipur,3.4 - Kidnapping & Abduction of Women to compel her for marriage,2014,488,0,102,102,104,0,0,0,0,0,0,8,2,10,64,74,516,22,10,0,0,32,1,4,0,1,1,0,3,3,27
Manipur,3.5 - Kidnapping & Abduction of Women-Other,2014,0,0,12,12,17,0,0,0,0,0,0,0,0,0,0,0,12,0,0,0,0,0,0,0,0,0,0,0,0,0,0
Manipur,4 - Dowry Deaths (Section 304-B IPC),2014,2,0,1,1,1,0,0,0,0,0,0,0,0,0,0,0,3,0,0,0,0,0,0,0,0,0,0,0,0,0,0
Manipur,5 - Assault on Women with intent to outrage her Modesty_Total (Section 354 IPC),2014,239,0,98,98,106,0,0,0,0,0,0,6,9,15,37,52,285,23,15,0,0,38,0,2,0,0,0,0,2,2,36
Manipur,5.1 - Sexual Harassment,2014,0,0,5,5,7,0,0,0,0,0,0,0,0,0,0,0,5,1,0,0,0,1,0,0,0,0,0,0,0,0,1
Manipur,5.2 - Assault on women with intent to Disrobe,2014,2,0,4,4,6,0,0,0,0,0,0,0,0,0,0,0,6,0,0,0,0,0,0,0,0,0,0,0,0,0,0
Manipur,5.3 - Voyeurism,2014,0,0,0,0,0,0,0,0,0,0,0,0,0,0,0,0,0,0,0,0,0,0,0,0,0,0,0,0,0,0,0
Manipur,5.4 - Stalking,2014,2,0,2,2,2,0,0,0,0,0,0,2,0,2,0,2,2,0,2,0,0,2,0,0,0,0,0,0,0,0,2
Manipur,5.5 - Others,2014,235,0,87,87,91,0,0,0,0,0,0,4,9,13,37,50,272,22,13,0,0,35,0,2,0,0,0,0,2,2,33
Manipur,6 - Insult to the Modesty of Women_Total (Section 509 IPC),2014,0,0,0,0,0,0,0,0,0,0,0,0,0,0,0,0,0,0,0,0,0,0,0,0,0,0,0,0,0,0,0
Manipur,6.1 - At Office premises,2014,0,0,0,0,0,0,0,0,0,0,0,0,0,0,0,0,0,0,0,0,0,0,0,0,0,0,0,0,0,0,0
Manipur,6.2 - Other places related to work,2014,0,0,0,0,0,0,0,0,0,0,0,0,0,0,0,0,0,0,0,0,0,0,0,0,0,0,0,0,0,0,0
Manipur,6.3 - In Public Transport system,2014,0,0,0,0,0,0,0,0,0,0,0,0,0,0,0,0,0,0,0,0,0,0,0,0,0,0,0,0,0,0,0
Manipur,6.4 - in Other Places,2014,0,0,0,0,0,0,0,0,0,0,0,0,0,0,0,0,0,0,0,0,0,0,0,0,0,0,0,0,0,0,0
Manipur,7 - Cruelty by Husband or his Relatives (Section 498A),2014,170,0,41,41,42,0,0,0,0,0,0,2,3,5,13,18,193,13,5,0,0,18,0,0,0,0,0,0,0,0,18
Manipur,8 - Importation of Girls from Foreign Country (Section 366B IPC),2014,0,0,0,0,0,0,0,0,0,0,0,0,0,0,0,0,0,0,0,0,0,0,0,0,0,0,0,0,0,0,0
Manipur,9 - Abetment of Suicides of Women u/s 306 IPC,2014,0,0,0,0,0,0,0,0,0,0,0,0,0,0,0,0,0,0,0,0,0,0,0,0,0,0,0,0,0,0,0
Manipur,"10 - Dowry Prohibition Act, 1961",2014,0,0,0,0,0,0,0,0,0,0,0,0,0,0,0,0,0,0,0,0,0,0,0,0,0,0,0,0,0,0,0
Manipur,"11 - Indecent Representation of Women (Prohibition) Act, 1986",2014,0,0,0,0,0,0,0,0,0,0,0,0,0,0,0,0,0,0,0,0,0,0,0,0,0,0,0,0,0,0,0
Manipur,12 - Commission of Sati Prevention Act 1987,2014,0,0,0,0,0,0,0,0,0,0,0,0,0,0,0,0,0,0,0,0,0,0,0,0,0,0,0,0,0,0,0
Manipur,"13 - Protection of Women from Domestic Violence Act, 2005",2014,0,0,0,0,0,0,0,0,0,0,0,0,0,0,0,0,0,0,0,0,0,0,0,0,0,0,0,0,0,0,0
Manipur,14 - Immoral Traffic (Prevention) Act (Women Cases only),2014,0,0,0,0,0,0,0,0,0,0,0,0,0,0,0,0,0,0,0,0,0,0,0,0,0,0,0,0,0,0,0
Manipur,14.1 - Under ITP Section 5,2014,0,0,0,0,0,0,0,0,0,0,0,0,0,0,0,0,0,0,0,0,0,0,0,0,0,0,0,0,0,0,0
Manipur,14.2 - Under ITP Section 6,2014,0,0,0,0,0,0,0,0,0,0,0,0,0,0,0,0,0,0,0,0,0,0,0,0,0,0,0,0,0,0,0
Manipur,14.3 - Under ITP Section 7,2014,0,0,0,0,0,0,0,0,0,0,0,0,0,0,0,0,0,0,0,0,0,0,0,0,0,0,0,0,0,0,0
Manipur,14.4 - Under ITP Section 8,2014,0,0,0,0,0,0,0,0,0,0,0,0,0,0,0,0,0,0,0,0,0,0,0,0,0,0,0,0,0,0,0
Manipur,14.5 - Other Sections under ITP Act,2014,0,0,0,0,0,0,0,0,0,0,0,0,0,0,0,0,0,0,0,0,0,0,0,0,0,0,0,0,0,0,0
Manipur,15 - Total Crimes against Women,2014,1167,0,337,337,353,0,0,0,0,0,0,36,35,71,129,200,1304,143,71,0,0,214,1,13,1,3,4,0,9,9,200
Meghalaya,1 - Rape (Section 376 IPC),2014,372,0,118,118,118,0,0,1,1,0,0,70,69,139,23,163,326,806,139,0,0,945,0,18,1,11,12,1,5,6,927
Meghalaya,1.1 - Custodial Rape,2014,0,0,0,0,0,0,0,0,0,0,0,0,0,0,0,0,0,0,0,0,0,0,0,0,0,0,0,0,0,0,0
Meghalaya,1.1.1 - Custodial_Gang Rape,2014,0,0,0,0,0,0,0,0,0,0,0,0,0,0,0,0,0,0,0,0,0,0,0,0,0,0,0,0,0,0,0
Meghalaya,1.1.2 - Custodial_Other Rape,2014,0,0,0,0,0,0,0,0,0,0,0,0,0,0,0,0,0,0,0,0,0,0,0,0,0,0,0,0,0,0,0
Meghalaya,1.2 - Rape other than Custodial,2014,372,0,118,118,118,0,0,1,1,0,0,70,69,139,23,163,326,806,139,0,0,945,0,18,1,11,12,1,5,6,927
Meghalaya,1.2.1 - Rape_Gang Rape,2014,0,0,3,3,3,0,0,0,0,0,0,2,0,2,0,2,1,0,2,0,0,2,0,0,0,0,0,0,0,0,2
Meghalaya,1.2.2 - Rape_Others,2014,372,0,115,115,115,0,0,1,1,0,0,68,69,137,23,161,325,806,137,0,0,943,0,18,1,11,12,1,5,6,925
Meghalaya,2 - Attempt to commit Rape (Section 376 & 511 IPC),2014,0,0,26,26,26,0,0,0,0,0,0,18,0,18,0,18,8,0,18,0,0,18,0,0,0,0,0,0,0,0,18
Meghalaya,"3 - Kidnapping & Abduction of Women (Section 363,364,364A, 366-369 IPC)",2014,133,0,38,38,46,0,0,1,0,0,0,9,13,22,14,36,134,68,22,0,0,90,0,0,0,0,0,0,0,0,90
Meghalaya,3.1 - Kidnaping & Abduction Section 363 IPC,2014,34,0,9,9,12,0,0,0,0,0,0,6,7,13,5,18,25,15,13,0,0,28,0,0,0,0,0,0,0,0,28
Meghalaya,3.2 - Kidnaping & Abduction in order to Murder Section 364 IPC,2014,0,0,0,0,0,0,0,0,0,0,0,0,0,0,0,0,0,0,0,0,0,0,0,0,0,0,0,0,0,0,0
Meghalaya,3.3 - Kidnapping for Ransom Section 364A,2014,0,0,1,1,1,0,0,0,0,0,0,0,0,0,0,0,1,0,0,0,0,0,0,0,0,0,0,0,0,0,0
Meghalaya,3.4 - Kidnapping & Abduction of Women to compel her for marriage,2014,79,0,9,9,10,0,0,1,0,0,0,0,2,2,5,7,80,39,2,0,0,41,0,0,0,0,0,0,0,0,41
Meghalaya,3.5 - Kidnapping & Abduction of Women-Other,2014,20,0,19,19,23,0,0,0,0,0,0,3,4,7,4,11,28,14,7,0,0,21,0,0,0,0,0,0,0,0,21
Meghalaya,4 - Dowry Deaths (Section 304-B IPC),2014,6,0,1,1,1,0,0,0,0,0,0,1,1,2,1,3,4,7,2,0,0,9,0,0,0,0,0,0,0,0,9
Meghalaya,5 - Assault on Women with intent to outrage her Modesty_Total (Section 354 IPC),2014,140,0,105,105,105,0,0,0,1,0,0,54,18,72,15,88,157,302,72,0,0,374,1,6,1,0,1,3,2,5,367
Meghalaya,5.1 - Sexual Harassment,2014,0,0,0,0,0,0,0,0,0,0,0,0,0,0,0,0,0,0,0,0,0,0,0,0,0,0,0,0,0,0,0
Meghalaya,5.2 - Assault on women with intent to Disrobe,2014,0,0,10,10,10,0,0,0,1,0,0,4,0,4,2,7,3,32,4,0,0,36,0,0,0,0,0,0,0,0,36
Meghalaya,5.3 - Voyeurism,2014,0,0,1,1,1,0,0,0,0,0,0,1,0,1,0,1,0,0,1,0,0,1,0,0,0,0,0,0,0,0,1
Meghalaya,5.4 - Stalking,2014,0,0,4,4,4,0,0,0,0,0,0,4,0,4,0,4,0,0,4,0,0,4,0,0,0,0,0,0,0,0,4
Meghalaya,5.5 - Others,2014,140,0,90,90,90,0,0,0,0,0,0,45,18,63,13,76,154,270,63,0,0,333,1,6,1,0,1,3,2,5,326
Meghalaya,6 - Insult to the Modesty of Women_Total (Section 509 IPC),2014,18,0,54,54,56,0,0,0,0,0,0,26,1,27,4,31,41,4,27,0,1,30,1,0,0,0,0,0,0,0,29
Meghalaya,6.1 - At Office premises,2014,0,0,0,0,0,0,0,0,0,0,0,0,0,0,0,0,0,0,0,0,0,0,0,0,0,0,0,0,0,0,0
Meghalaya,6.2 - Other places related to work,2014,0,0,0,0,0,0,0,0,0,0,0,0,0,0,0,0,0,0,0,0,0,0,0,0,0,0,0,0,0,0,0
Meghalaya,6.3 - In Public Transport system,2014,0,0,0,0,0,0,0,0,0,0,0,0,0,0,0,0,0,0,0,0,0,0,0,0,0,0,0,0,0,0,0
Meghalaya,6.4 - in Other Places,2014,18,0,54,54,56,0,0,0,0,0,0,26,1,27,4,31,41,4,27,0,1,30,1,0,0,0,0,0,0,0,29
Meghalaya,7 - Cruelty by Husband or his Relatives (Section 498A),2014,58,0,42,42,42,0,0,0,1,0,0,16,16,32,7,40,60,60,32,0,0,92,1,1,0,0,0,1,0,1,90
Meghalaya,8 - Importation of Girls from Foreign Country (Section 366B IPC),2014,0,0,0,0,0,0,0,0,0,0,0,0,0,0,0,0,0,2,0,0,0,2,0,0,0,0,0,0,0,0,2
Meghalaya,9 - Abetment of Suicides of Women u/s 306 IPC,2014,0,0,0,0,0,0,0,0,0,0,0,0,0,0,0,0,0,0,0,0,0,0,0,0,0,0,0,0,0,0,0
Meghalaya,"10 - Dowry Prohibition Act, 1961",2014,0,0,1,1,1,0,0,0,0,0,0,0,0,0,0,0,1,0,0,0,0,0,0,0,0,0,0,0,0,0,0
Meghalaya,"11 - Indecent Representation of Women (Prohibition) Act, 1986",2014,0,0,0,0,0,0,0,0,0,0,0,0,0,0,0,0,0,0,0,0,0,0,0,0,0,0,0,0,0,0,0
Meghalaya,12 - Commission of Sati Prevention Act 1987,2014,0,0,0,0,0,0,0,0,0,0,0,0,0,0,0,0,0,0,0,0,0,0,0,0,0,0,0,0,0,0,0
Meghalaya,"13 - Protection of Women from Domestic Violence Act, 2005",2014,0,0,0,0,0,0,0,0,0,0,0,0,0,0,0,0,0,0,0,0,0,0,0,0,0,0,0,0,0,0,0
Meghalaya,14 - Immoral Traffic (Prevention) Act (Women Cases only),2014,6,0,3,3,3,0,0,0,0,0,0,0,0,0,2,2,7,0,0,0,0,0,0,0,0,0,0,0,0,0,0
Meghalaya,14.1 - Under ITP Section 5,2014,6,0,3,3,3,0,0,0,0,0,0,0,0,0,2,2,7,0,0,0,0,0,0,0,0,0,0,0,0,0,0
Meghalaya,14.2 - Under ITP Section 6,2014,0,0,0,0,0,0,0,0,0,0,0,0,0,0,0,0,0,0,0,0,0,0,0,0,0,0,0,0,0,0,0
Meghalaya,14.3 - Under ITP Section 7,2014,0,0,0,0,0,0,0,0,0,0,0,0,0,0,0,0,0,0,0,0,0,0,0,0,0,0,0,0,0,0,0
Meghalaya,14.4 - Under ITP Section 8,2014,0,0,0,0,0,0,0,0,0,0,0,0,0,0,0,0,0,0,0,0,0,0,0,0,0,0,0,0,0,0,0
Meghalaya,14.5 - Other Sections under ITP Act,2014,0,0,0,0,0,0,0,0,0,0,0,0,0,0,0,0,0,0,0,0,0,0,0,0,0,0,0,0,0,0,0
Meghalaya,15 - Total Crimes against Women,2014,733,0,388,388,398,0,0,2,3,0,0,194,118,312,66,381,738,1249,312,0,1,1560,3,25,2,11,13,5,7,12,1532
Mizoram,1 - Rape (Section 376 IPC),2014,44,0,120,120,122,0,0,0,0,0,0,66,40,106,0,106,58,139,106,0,0,245,0,54,4,37,41,3,10,13,191
Mizoram,1.1 - Custodial Rape,2014,0,0,0,0,0,0,0,0,0,0,0,0,0,0,0,0,0,0,0,0,0,0,0,0,0,0,0,0,0,0,0
Mizoram,1.1.1 - Custodial_Gang Rape,2014,0,0,0,0,0,0,0,0,0,0,0,0,0,0,0,0,0,0,0,0,0,0,0,0,0,0,0,0,0,0,0
Mizoram,1.1.2 - Custodial_Other Rape,2014,0,0,0,0,0,0,0,0,0,0,0,0,0,0,0,0,0,0,0,0,0,0,0,0,0,0,0,0,0,0,0
Mizoram,1.2 - Rape other than Custodial,2014,44,0,120,120,122,0,0,0,0,0,0,66,40,106,0,106,58,139,106,0,0,245,0,54,4,37,41,3,10,13,191
Mizoram,1.2.1 - Rape_Gang Rape,2014,0,0,7,7,7,0,0,0,0,0,0,5,0,5,0,5,2,0,5,0,0,5,0,0,0,0,0,0,0,0,5
Mizoram,1.2.2 - Rape_Others,2014,44,0,113,113,115,0,0,0,0,0,0,61,40,101,0,101,56,139,101,0,0,240,0,54,4,37,41,3,10,13,186
Mizoram,2 - Attempt to commit Rape (Section 376 & 511 IPC),2014,0,0,1,1,1,0,0,0,0,0,0,0,0,0,0,0,1,0,0,0,0,0,0,0,0,0,0,0,0,0,0
Mizoram,"3 - Kidnapping & Abduction of Women (Section 363,364,364A, 366-369 IPC)",2014,0,0,3,3,3,0,0,0,0,0,0,2,0,2,0,2,1,0,2,0,0,2,0,0,0,0,0,0,0,0,2
Mizoram,3.1 - Kidnaping & Abduction Section 363 IPC,2014,0,0,2,2,2,0,0,0,0,0,0,1,0,1,0,1,1,0,1,0,0,1,0,0,0,0,0,0,0,0,1
Mizoram,3.2 - Kidnaping & Abduction in order to Murder Section 364 IPC,2014,0,0,0,0,0,0,0,0,0,0,0,0,0,0,0,0,0,0,0,0,0,0,0,0,0,0,0,0,0,0,0
Mizoram,3.3 - Kidnapping for Ransom Section 364A,2014,0,0,0,0,0,0,0,0,0,0,0,0,0,0,0,0,0,0,0,0,0,0,0,0,0,0,0,0,0,0,0
Mizoram,3.4 - Kidnapping & Abduction of Women to compel her for marriage,2014,0,0,0,0,0,0,0,0,0,0,0,0,0,0,0,0,0,0,0,0,0,0,0,0,0,0,0,0,0,0,0
Mizoram,3.5 - Kidnapping & Abduction of Women-Other,2014,0,0,1,1,1,0,0,0,0,0,0,1,0,1,0,1,0,0,1,0,0,1,0,0,0,0,0,0,0,0,1
Mizoram,4 - Dowry Deaths (Section 304-B IPC),2014,0,0,0,0,0,0,0,0,0,0,0,0,0,0,0,0,0,0,0,0,0,0,0,0,0,0,0,0,0,0,0
Mizoram,5 - Assault on Women with intent to outrage her Modesty_Total (Section 354 IPC),2014,20,0,97,97,102,0,0,0,0,0,0,78,20,98,0,98,19,71,98,1,0,168,1,109,32,62,94,7,8,15,58
Mizoram,5.1 - Sexual Harassment,2014,1,0,53,53,53,0,0,0,0,0,0,44,1,45,0,45,9,30,45,1,0,74,1,35,13,18,31,4,0,4,38
Mizoram,5.2 - Assault on women with intent to Disrobe,2014,19,0,12,12,12,0,0,0,0,0,0,9,19,28,0,28,3,34,28,0,0,62,0,50,4,39,43,1,6,7,12
Mizoram,5.3 - Voyeurism,2014,0,0,2,2,2,0,0,0,0,0,0,2,0,2,0,2,0,7,2,0,0,9,0,7,0,5,5,0,2,2,2
Mizoram,5.4 - Stalking,2014,0,0,6,6,6,0,0,0,0,0,0,6,0,6,0,6,0,0,6,0,0,6,0,4,4,0,4,0,0,0,2
Mizoram,5.5 - Others,2014,0,0,24,24,29,0,0,0,0,0,0,17,0,17,0,17,7,0,17,0,0,17,0,13,11,0,11,2,0,2,4
Mizoram,6 - Insult to the Modesty of Women_Total (Section 509 IPC),2014,0,0,29,29,29,0,0,0,0,0,0,28,0,28,0,28,1,12,28,0,0,40,0,0,0,0,0,0,0,0,40
Mizoram,6.1 - At Office premises,2014,0,0,0,0,0,0,0,0,0,0,0,0,0,0,0,0,0,0,0,0,0,0,0,0,0,0,0,0,0,0,0
Mizoram,6.2 - Other places related to work,2014,0,0,29,29,29,0,0,0,0,0,0,28,0,28,0,28,1,12,28,0,0,40,0,0,0,0,0,0,0,0,40
Mizoram,6.3 - In Public Transport system,2014,0,0,0,0,0,0,0,0,0,0,0,0,0,0,0,0,0,0,0,0,0,0,0,0,0,0,0,0,0,0,0
Mizoram,6.4 - in Other Places,2014,0,0,0,0,0,0,0,0,0,0,0,0,0,0,0,0,0,0,0,0,0,0,0,0,0,0,0,0,0,0,0
Mizoram,7 - Cruelty by Husband or his Relatives (Section 498A),2014,0,0,8,8,8,0,0,0,0,0,0,6,0,6,0,6,2,4,6,0,0,10,0,5,3,1,4,1,0,1,5
Mizoram,8 - Importation of Girls from Foreign Country (Section 366B IPC),2014,0,0,0,0,0,0,0,0,0,0,0,0,0,0,0,0,0,0,0,0,0,0,0,0,0,0,0,0,0,0,0
Mizoram,9 - Abetment of Suicides of Women u/s 306 IPC,2014,0,0,0,0,0,0,0,0,0,0,0,0,0,0,0,0,0,0,0,0,0,0,0,0,0,0,0,0,0,0,0
Mizoram,"10 - Dowry Prohibition Act, 1961",2014,0,0,0,0,0,0,0,0,0,0,0,0,0,0,0,0,0,0,0,0,0,0,0,0,0,0,0,0,0,0,0
Mizoram,"11 - Indecent Representation of Women (Prohibition) Act, 1986",2014,0,0,0,0,0,0,0,0,0,0,0,0,0,0,0,0,0,0,0,0,0,0,0,0,0,0,0,0,0,0,0
Mizoram,12 - Commission of Sati Prevention Act 1987,2014,0,0,0,0,0,0,0,0,0,0,0,0,0,0,0,0,0,0,0,0,0,0,0,0,0,0,0,0,0,0,0
Mizoram,"13 - Protection of Women from Domestic Violence Act, 2005",2014,0,0,0,0,0,0,0,0,0,0,0,0,0,0,0,0,0,0,0,0,0,0,0,0,0,0,0,0,0,0,0
Mizoram,14 - Immoral Traffic (Prevention) Act (Women Cases only),2014,0,0,0,0,0,0,0,0,0,0,0,0,0,0,0,0,0,0,0,0,0,0,0,0,0,0,0,0,0,0,0
Mizoram,14.1 - Under ITP Section 5,2014,0,0,0,0,0,0,0,0,0,0,0,0,0,0,0,0,0,0,0,0,0,0,0,0,0,0,0,0,0,0,0
Mizoram,14.2 - Under ITP Section 6,2014,0,0,0,0,0,0,0,0,0,0,0,0,0,0,0,0,0,0,0,0,0,0,0,0,0,0,0,0,0,0,0
Mizoram,14.3 - Under ITP Section 7,2014,0,0,0,0,0,0,0,0,0,0,0,0,0,0,0,0,0,0,0,0,0,0,0,0,0,0,0,0,0,0,0
Mizoram,14.4 - Under ITP Section 8,2014,0,0,0,0,0,0,0,0,0,0,0,0,0,0,0,0,0,0,0,0,0,0,0,0,0,0,0,0,0,0,0
Mizoram,14.5 - Other Sections under ITP Act,2014,0,0,0,0,0,0,0,0,0,0,0,0,0,0,0,0,0,0,0,0,0,0,0,0,0,0,0,0,0,0,0
Mizoram,15 - Total Crimes against Women,2014,64,0,258,258,265,0,0,0,0,0,0,180,60,240,0,240,82,226,240,1,0,465,1,168,39,100,139,11,18,29,296
Nagaland,1 - Rape (Section 376 IPC),2014,13,0,30,30,32,0,0,0,0,0,0,18,8,26,6,32,11,19,26,0,0,45,1,18,6,8,14,0,4,4,26
Nagaland,1.1 - Custodial Rape,2014,0,0,0,0,0,0,0,0,0,0,0,0,0,0,0,0,0,2,0,0,0,2,0,0,0,0,0,0,0,0,2
Nagaland,1.1.1 - Custodial_Gang Rape,2014,0,0,0,0,0,0,0,0,0,0,0,0,0,0,0,0,0,0,0,0,0,0,0,0,0,0,0,0,0,0,0
Nagaland,1.1.2 - Custodial_Other Rape,2014,0,0,0,0,0,0,0,0,0,0,0,0,0,0,0,0,0,2,0,0,0,2,0,0,0,0,0,0,0,0,2
Nagaland,1.2 - Rape other than Custodial,2014,13,0,30,30,32,0,0,0,0,0,0,18,8,26,6,32,11,17,26,0,0,43,1,18,6,8,14,0,4,4,24
Nagaland,1.2.1 - Rape_Gang Rape,2014,0,0,4,4,4,0,0,0,0,0,0,0,1,1,0,1,3,0,1,0,0,1,0,0,0,0,0,0,0,0,1
Nagaland,1.2.2 - Rape_Others,2014,13,0,26,26,28,0,0,0,0,0,0,18,7,25,6,31,8,17,25,0,0,42,1,18,6,8,14,0,4,4,23
Nagaland,2 - Attempt to commit Rape (Section 376 & 511 IPC),2014,0,0,3,3,3,0,0,0,0,0,0,1,0,1,0,1,2,0,1,0,0,1,0,0,0,0,0,0,0,0,1
Nagaland,"3 - Kidnapping & Abduction of Women (Section 363,364,364A, 366-369 IPC)",2014,0,0,13,13,15,0,0,0,0,0,0,6,0,6,1,7,6,0,6,0,0,6,0,1,1,0,1,0,0,0,5
Nagaland,3.1 - Kidnaping & Abduction Section 363 IPC,2014,0,0,3,3,4,0,0,0,0,0,0,0,0,0,0,0,3,0,0,0,0,0,0,0,0,0,0,0,0,0,0
Nagaland,3.2 - Kidnaping & Abduction in order to Murder Section 364 IPC,2014,0,0,0,0,0,0,0,0,0,0,0,0,0,0,0,0,0,0,0,0,0,0,0,0,0,0,0,0,0,0,0
Nagaland,3.3 - Kidnapping for Ransom Section 364A,2014,0,0,0,0,0,0,0,0,0,0,0,0,0,0,0,0,0,0,0,0,0,0,0,0,0,0,0,0,0,0,0
Nagaland,3.4 - Kidnapping & Abduction of Women to compel her for marriage,2014,0,0,2,2,2,0,0,0,0,0,0,0,0,0,0,0,2,0,0,0,0,0,0,0,0,0,0,0,0,0,0
Nagaland,3.5 - Kidnapping & Abduction of Women-Other,2014,0,0,8,8,9,0,0,0,0,0,0,6,0,6,1,7,1,0,6,0,0,6,0,1,1,0,1,0,0,0,5
Nagaland,4 - Dowry Deaths (Section 304-B IPC),2014,1,0,0,0,0,0,0,0,0,0,0,0,1,1,0,1,0,0,1,0,0,1,0,0,0,0,0,0,0,0,1
Nagaland,5 - Assault on Women with intent to outrage her Modesty_Total (Section 354 IPC),2014,5,0,16,16,16,0,0,0,0,0,0,4,3,7,1,8,13,9,7,0,0,16,0,6,1,4,5,0,1,1,10
Nagaland,5.1 - Sexual Harassment,2014,0,0,5,5,5,0,0,0,0,0,0,2,0,2,0,2,3,0,2,0,0,2,0,1,1,0,1,0,0,0,1
Nagaland,5.2 - Assault on women with intent to Disrobe,2014,0,0,5,5,5,0,0,0,0,0,0,1,0,1,0,1,4,1,1,0,0,2,0,0,0,0,0,0,0,0,2
Nagaland,5.3 - Voyeurism,2014,0,0,0,0,0,0,0,0,0,0,0,0,0,0,0,0,0,0,0,0,0,0,0,0,0,0,0,0,0,0,0
Nagaland,5.4 - Stalking,2014,0,0,1,1,1,0,0,0,0,0,0,0,0,0,0,0,1,0,0,0,0,0,0,0,0,0,0,0,0,0,0
Nagaland,5.5 - Others,2014,5,0,5,5,5,0,0,0,0,0,0,1,3,4,1,5,5,8,4,0,0,12,0,5,0,4,4,0,1,1,7
Nagaland,6 - Insult to the Modesty of Women_Total (Section 509 IPC),2014,0,0,1,1,1,0,0,0,0,0,0,0,0,0,0,0,1,0,0,0,0,0,0,0,0,0,0,0,0,0,0
Nagaland,6.1 - At Office premises,2014,0,0,0,0,0,0,0,0,0,0,0,0,0,0,0,0,0,0,0,0,0,0,0,0,0,0,0,0,0,0,0
Nagaland,6.2 - Other places related to work,2014,0,0,0,0,0,0,0,0,0,0,0,0,0,0,0,0,0,0,0,0,0,0,0,0,0,0,0,0,0,0,0
Nagaland,6.3 - In Public Transport system,2014,0,0,0,0,0,0,0,0,0,0,0,0,0,0,0,0,0,0,0,0,0,0,0,0,0,0,0,0,0,0,0
Nagaland,6.4 - in Other Places,2014,0,0,1,1,1,0,0,0,0,0,0,0,0,0,0,0,1,0,0,0,0,0,0,0,0,0,0,0,0,0,0
Nagaland,7 - Cruelty by Husband or his Relatives (Section 498A),2014,3,0,3,3,3,0,0,0,0,0,0,1,3,4,0,4,2,1,4,0,0,5,0,2,1,1,2,0,0,0,3
Nagaland,8 - Importation of Girls from Foreign Country (Section 366B IPC),2014,0,0,0,0,0,0,0,0,0,0,0,0,0,0,0,0,0,0,0,0,0,0,0,0,0,0,0,0,0,0,0
Nagaland,9 - Abetment of Suicides of Women u/s 306 IPC,2014,0,0,0,0,0,0,0,0,0,0,0,0,0,0,0,0,0,0,0,0,0,0,0,0,0,0,0,0,0,0,0
Nagaland,"10 - Dowry Prohibition Act, 1961",2014,0,0,0,0,0,0,0,0,0,0,0,0,0,0,0,0,0,0,0,0,0,0,0,0,0,0,0,0,0,0,0
Nagaland,"11 - Indecent Representation of Women (Prohibition) Act, 1986",2014,0,0,0,0,0,0,0,0,0,0,0,0,0,0,0,0,0,0,0,0,0,0,0,0,0,0,0,0,0,0,0
Nagaland,12 - Commission of Sati Prevention Act 1987,2014,0,0,0,0,0,0,0,0,0,0,0,0,0,0,0,0,0,0,0,0,0,0,0,0,0,0,0,0,0,0,0
Nagaland,"13 - Protection of Women from Domestic Violence Act, 2005",2014,0,0,0,0,0,0,0,0,0,0,0,0,0,0,0,0,0,0,0,0,0,0,0,0,0,0,0,0,0,0,0
Nagaland,14 - Immoral Traffic (Prevention) Act (Women Cases only),2014,1,0,1,1,1,0,0,0,0,0,0,0,1,1,0,1,1,0,1,0,0,1,0,0,0,0,0,0,0,0,1
Nagaland,14.1 - Under ITP Section 5,2014,1,0,1,1,1,0,0,0,0,0,0,0,1,1,0,1,1,0,1,0,0,1,0,0,0,0,0,0,0,0,1
Nagaland,14.2 - Under ITP Section 6,2014,0,0,0,0,0,0,0,0,0,0,0,0,0,0,0,0,0,0,0,0,0,0,0,0,0,0,0,0,0,0,0
Nagaland,14.3 - Under ITP Section 7,2014,0,0,0,0,0,0,0,0,0,0,0,0,0,0,0,0,0,0,0,0,0,0,0,0,0,0,0,0,0,0,0
Nagaland,14.4 - Under ITP Section 8,2014,0,0,0,0,0,0,0,0,0,0,0,0,0,0,0,0,0,0,0,0,0,0,0,0,0,0,0,0,0,0,0
Nagaland,14.5 - Other Sections under ITP Act,2014,0,0,0,0,0,0,0,0,0,0,0,0,0,0,0,0,0,0,0,0,0,0,0,0,0,0,0,0,0,0,0
Nagaland,15 - Total Crimes against Women,2014,23,0,67,67,71,0,0,0,0,0,0,30,16,46,8,54,36,29,46,0,0,75,1,27,9,13,22,0,5,5,47
Odisha,1 - Rape (Section 376 IPC),2014,890,31,1947,1978,1980,0,0,8,35,24,0,1216,445,1661,6,1726,1134,6134,1661,0,0,7795,0,761,5,136,141,55,565,620,7034
Odisha,1.1 - Custodial Rape,2014,0,0,0,0,0,0,0,0,0,0,0,0,0,0,0,0,0,0,0,0,0,0,0,0,0,0,0,0,0,0,0
Odisha,1.1.1 - Custodial_Gang Rape,2014,0,0,0,0,0,0,0,0,0,0,0,0,0,0,0,0,0,0,0,0,0,0,0,0,0,0,0,0,0,0,0
Odisha,1.1.2 - Custodial_Other Rape,2014,0,0,0,0,0,0,0,0,0,0,0,0,0,0,0,0,0,0,0,0,0,0,0,0,0,0,0,0,0,0,0
Odisha,1.2 - Rape other than Custodial,2014,890,31,1947,1978,1980,0,0,8,35,24,0,1216,445,1661,6,1726,1134,6134,1661,0,0,7795,0,761,5,136,141,55,565,620,7034
Odisha,1.2.1 - Rape_Gang Rape,2014,4,3,79,82,83,0,0,0,5,1,0,47,2,49,1,56,30,42,49,0,0,91,0,4,1,0,1,0,3,3,87
Odisha,1.2.2 - Rape_Others,2014,886,28,1868,1896,1897,0,0,8,30,23,0,1169,443,1612,5,1670,1104,6092,1612,0,0,7704,0,757,4,136,140,55,562,617,6947
Odisha,2 - Attempt to commit Rape (Section 376 & 511 IPC),2014,0,0,33,33,33,0,0,0,1,2,0,14,0,14,0,17,16,0,14,0,0,14,0,3,0,1,1,0,2,2,11
Odisha,"3 - Kidnapping & Abduction of Women (Section 363,364,364A, 366-369 IPC)",2014,1180,16,2420,2436,2455,0,0,2,104,476,1,727,379,1106,69,1756,1858,3732,1106,0,0,4838,0,464,3,44,47,16,401,417,4374
Odisha,3.1 - Kidnaping & Abduction Section 363 IPC,2014,109,3,846,849,856,0,0,1,22,153,0,220,71,291,13,479,478,536,291,0,0,827,0,48,0,4,4,1,43,44,779
Odisha,3.2 - Kidnaping & Abduction in order to Murder Section 364 IPC,2014,0,0,2,2,2,0,0,0,0,0,0,2,0,2,0,2,0,0,2,0,0,2,0,0,0,0,0,0,0,0,2
Odisha,3.3 - Kidnapping for Ransom Section 364A,2014,0,0,4,4,4,0,0,0,0,0,0,2,0,2,0,2,2,0,2,0,0,2,0,0,0,0,0,0,0,0,2
Odisha,3.4 - Kidnapping & Abduction of Women to compel her for marriage,2014,995,13,1300,1313,1313,0,0,0,48,291,1,437,285,722,50,1112,1196,3007,722,0,0,3729,0,349,0,39,39,2,308,310,3380
Odisha,3.5 - Kidnapping & Abduction of Women-Other,2014,76,0,268,268,280,0,0,1,34,32,0,66,23,89,6,161,182,189,89,0,0,278,0,67,3,1,4,13,50,63,211
Odisha,4 - Dowry Deaths (Section 304-B IPC),2014,422,1,440,441,441,0,0,0,11,8,0,242,224,466,0,485,378,1950,466,0,0,2416,0,373,1,40,41,9,323,332,2043
Odisha,5 - Assault on Women with intent to outrage her Modesty_Total (Section 354 IPC),2014,1162,153,5390,5543,5580,0,0,0,206,171,3,3760,863,4623,90,5093,1612,21924,4623,0,0,26547,0,1774,0,65,65,110,1599,1709,24773
Odisha,5.1 - Sexual Harassment,2014,52,8,794,802,809,0,0,0,19,13,0,602,49,651,5,688,166,152,651,0,0,803,0,140,0,2,2,59,79,138,663
Odisha,5.2 - Assault on women with intent to Disrobe,2014,40,26,1116,1142,1152,0,0,0,33,27,1,787,30,817,30,908,274,86,817,0,0,903,0,28,0,0,0,16,12,28,875
Odisha,5.3 - Voyeurism,2014,0,1,27,28,28,0,0,0,2,0,0,23,0,23,0,25,3,0,23,0,0,23,0,0,0,0,0,0,0,0,23
Odisha,5.4 - Stalking,2014,1,1,133,134,139,0,0,0,5,4,0,93,1,94,1,104,31,1,94,0,0,95,0,6,0,0,0,6,0,6,89
Odisha,5.5 - Others,2014,1069,117,3320,3437,3452,0,0,0,147,127,2,2255,783,3038,54,3368,1138,21685,3038,0,0,24723,0,1600,0,63,63,29,1508,1537,23123
Odisha,6 - Insult to the Modesty of Women_Total (Section 509 IPC),2014,113,9,370,379,384,0,0,0,13,8,0,297,63,360,7,388,104,1519,360,0,0,1879,0,104,1,4,5,17,82,99,1775
Odisha,6.1 - At Office premises,2014,0,0,8,8,8,0,0,0,0,0,0,6,0,6,0,6,2,58,6,0,0,64,0,0,0,0,0,0,0,0,64
Odisha,6.2 - Other places related to work,2014,3,0,10,10,10,0,0,0,0,0,0,9,1,10,0,10,3,28,10,0,0,38,0,0,0,0,0,0,0,0,38
Odisha,6.3 - In Public Transport system,2014,0,0,1,1,1,0,0,0,0,0,0,1,0,1,0,1,0,6,1,0,0,7,0,0,0,0,0,0,0,0,7
Odisha,6.4 - in Other Places,2014,110,9,351,360,365,0,0,0,13,8,0,281,62,343,7,371,99,1427,343,0,0,1770,0,104,1,4,5,17,82,99,1666
Odisha,7 - Cruelty by Husband or his Relatives (Section 498A),2014,1546,199,2915,3114,3124,0,0,3,35,56,0,1742,1229,2971,16,3078,1579,10805,2971,0,0,13776,0,1602,2,97,99,77,1426,1503,12174
Odisha,8 - Importation of Girls from Foreign Country (Section 366B IPC),2014,0,0,0,0,0,0,0,0,0,0,0,0,0,0,0,0,0,17,0,0,0,17,0,4,0,0,0,0,4,4,13
Odisha,9 - Abetment of Suicides of Women u/s 306 IPC,2014,0,0,4,4,4,0,0,0,0,0,0,1,0,1,0,1,3,0,1,0,0,1,0,0,0,0,0,0,0,0,1
Odisha,"10 - Dowry Prohibition Act, 1961",2014,982,58,588,646,646,0,0,0,81,40,0,400,554,954,23,1098,530,5969,954,0,0,6923,0,1325,2,27,29,3,1293,1296,5598
Odisha,"11 - Indecent Representation of Women (Prohibition) Act, 1986",2014,1,0,0,0,0,0,0,0,0,0,0,0,0,0,0,0,1,5,0,0,0,5,0,4,0,0,0,0,4,4,1
Odisha,12 - Commission of Sati Prevention Act 1987,2014,0,0,0,0,0,0,0,0,0,0,0,0,0,0,0,0,0,0,0,0,0,0,0,0,0,0,0,0,0,0,0
Odisha,"13 - Protection of Women from Domestic Violence Act, 2005",2014,0,0,0,0,0,0,0,0,0,0,0,0,0,0,0,0,0,0,0,0,0,0,0,0,0,0,0,0,0,0,0
Odisha,14 - Immoral Traffic (Prevention) Act (Women Cases only),2014,6,0,32,32,36,0,0,0,0,0,0,12,4,16,0,16,22,42,16,0,0,58,0,7,0,1,1,0,6,6,51
Odisha,14.1 - Under ITP Section 5,2014,0,0,7,7,7,0,0,0,0,0,0,4,0,4,0,4,3,16,4,0,0,20,0,0,0,0,0,0,0,0,20
Odisha,14.2 - Under ITP Section 6,2014,0,0,0,0,0,0,0,0,0,0,0,0,0,0,0,0,0,0,0,0,0,0,0,0,0,0,0,0,0,0,0
Odisha,14.3 - Under ITP Section 7,2014,0,0,1,1,5,0,0,0,0,0,0,1,0,1,0,1,0,0,1,0,0,1,0,0,0,0,0,0,0,0,1
Odisha,14.4 - Under ITP Section 8,2014,0,0,0,0,0,0,0,0,0,0,0,0,0,0,0,0,0,0,0,0,0,0,0,0,0,0,0,0,0,0,0
Odisha,14.5 - Other Sections under ITP Act,2014,6,0,24,24,24,0,0,0,0,0,0,7,4,11,0,11,19,26,11,0,0,37,0,7,0,1,1,0,6,6,30
Odisha,15 - Total Crimes against Women,2014,6302,467,14139,14606,14683,0,0,13,486,785,4,8411,3761,12172,211,13658,7237,52097,12172,0,0,64269,0,6421,14,415,429,287,5705,5992,57848
Punjab,1 - Rape (Section 376 IPC),2014,256,0,981,981,983,0,0,0,115,6,0,597,200,797,18,936,301,477,797,0,0,1274,1,743,92,184,276,213,254,467,530
Punjab,1.1 - Custodial Rape,2014,0,0,0,0,0,0,0,0,0,0,0,0,0,0,0,0,0,0,0,0,0,0,0,0,0,0,0,0,0,0,0
Punjab,1.1.1 - Custodial_Gang Rape,2014,0,0,0,0,0,0,0,0,0,0,0,0,0,0,0,0,0,0,0,0,0,0,0,0,0,0,0,0,0,0,0
Punjab,1.1.2 - Custodial_Other Rape,2014,0,0,0,0,0,0,0,0,0,0,0,0,0,0,0,0,0,0,0,0,0,0,0,0,0,0,0,0,0,0,0
Punjab,1.2 - Rape other than Custodial,2014,256,0,981,981,983,0,0,0,115,6,0,597,200,797,18,936,301,477,797,0,0,1274,1,743,92,184,276,213,254,467,530
Punjab,1.2.1 - Rape_Gang Rape,2014,3,0,24,24,24,0,0,0,2,0,0,13,3,16,0,18,9,2,16,0,0,18,0,4,0,2,2,1,1,2,14
Punjab,1.2.2 - Rape_Others,2014,253,0,957,957,959,0,0,0,113,6,0,584,197,781,18,918,292,475,781,0,0,1256,1,739,92,182,274,212,253,465,516
Punjab,2 - Attempt to commit Rape (Section 376 & 511 IPC),2014,21,0,154,154,154,0,0,0,16,4,0,68,15,83,3,106,69,40,83,0,0,123,0,38,6,12,18,13,7,20,85
Punjab,"3 - Kidnapping & Abduction of Women (Section 363,364,364A, 366-369 IPC)",2014,528,0,1176,1176,1208,0,0,0,296,67,0,262,162,424,88,875,829,874,424,0,2,1296,4,287,17,50,67,63,157,220,1005
Punjab,3.1 - Kidnaping & Abduction Section 363 IPC,2014,41,0,86,86,89,0,0,0,7,1,0,20,5,25,3,36,91,46,25,0,0,71,0,17,2,1,3,13,1,14,54
Punjab,3.2 - Kidnaping & Abduction in order to Murder Section 364 IPC,2014,1,0,0,0,0,0,0,0,0,0,0,0,0,0,0,0,1,0,0,0,0,0,0,0,0,0,0,0,0,0,0
Punjab,3.3 - Kidnapping for Ransom Section 364A,2014,0,0,1,1,1,0,0,0,0,0,0,1,0,1,0,1,0,0,1,0,0,1,0,0,0,0,0,0,0,0,1
Punjab,3.4 - Kidnapping & Abduction of Women to compel her for marriage,2014,399,0,806,806,817,0,0,0,235,53,0,187,119,306,68,662,543,524,306,0,2,828,1,231,11,44,55,47,129,176,596
Punjab,3.5 - Kidnapping & Abduction of Women-Other,2014,87,0,283,283,301,0,0,0,54,13,0,54,38,92,17,176,194,304,92,0,0,396,3,39,4,5,9,3,27,30,354
Punjab,4 - Dowry Deaths (Section 304-B IPC),2014,88,0,90,90,90,0,0,0,8,1,0,42,38,80,0,89,89,186,80,0,0,266,0,85,3,35,38,10,37,47,181
Punjab,5 - Assault on Women with intent to outrage her Modesty_Total (Section 354 IPC),2014,519,0,1113,1113,1114,0,0,0,137,73,0,421,244,665,26,901,731,893,665,0,4,1554,0,339,24,77,101,62,176,238,1215
Punjab,5.1 - Sexual Harassment,2014,128,0,344,344,344,0,0,0,33,38,0,117,74,191,8,270,202,165,191,0,4,352,0,49,3,9,12,12,25,37,303
Punjab,5.2 - Assault on women with intent to Disrobe,2014,3,0,41,41,41,0,0,0,2,3,0,24,3,27,0,32,12,6,27,0,0,33,0,6,0,1,1,3,2,5,27
Punjab,5.3 - Voyeurism,2014,56,0,48,48,48,0,0,0,2,0,0,10,0,10,0,12,92,54,10,0,0,64,0,8,2,0,2,6,0,6,56
Punjab,5.4 - Stalking,2014,3,0,48,48,48,0,0,0,6,1,0,17,2,19,2,28,23,4,19,0,0,23,0,3,1,0,1,2,0,2,20
Punjab,5.5 - Others,2014,329,0,632,632,633,0,0,0,94,31,0,253,165,418,16,559,402,664,418,0,0,1082,0,273,18,67,85,39,149,188,809
Punjab,6 - Insult to the Modesty of Women_Total (Section 509 IPC),2014,22,0,35,35,35,0,0,0,1,2,0,15,8,23,0,26,31,11,23,0,0,34,0,8,2,1,3,2,3,5,26
Punjab,6.1 - At Office premises,2014,0,0,0,0,0,0,0,0,0,0,0,0,0,0,0,0,0,0,0,0,0,0,0,0,0,0,0,0,0,0,0
Punjab,6.2 - Other places related to work,2014,0,0,3,3,3,0,0,0,0,0,0,3,0,3,0,3,0,5,3,0,0,8,0,1,0,0,0,1,0,1,7
Punjab,6.3 - In Public Transport system,2014,0,0,0,0,0,0,0,0,0,0,0,0,0,0,0,0,0,0,0,0,0,0,0,0,0,0,0,0,0,0,0
Punjab,6.4 - in Other Places,2014,22,0,32,32,32,0,0,0,1,2,0,12,8,20,0,23,31,6,20,0,0,26,0,7,2,1,3,1,3,4,19
Punjab,7 - Cruelty by Husband or his Relatives (Section 498A),2014,1384,0,1681,1681,1682,0,0,0,189,53,0,411,547,958,102,1302,1763,3576,958,0,9,4525,5,516,17,85,102,52,362,414,4004
Punjab,8 - Importation of Girls from Foreign Country (Section 366B IPC),2014,0,0,0,0,0,0,0,0,0,0,0,0,0,0,0,0,0,0,0,0,0,0,0,0,0,0,0,0,0,0,0
Punjab,9 - Abetment of Suicides of Women u/s 306 IPC,2014,22,0,124,124,124,0,0,0,9,2,0,64,17,81,2,94,52,68,81,0,0,149,0,50,3,16,19,6,25,31,99
Punjab,"10 - Dowry Prohibition Act, 1961",2014,2,0,5,5,5,0,0,0,1,0,0,1,0,1,0,2,5,7,1,0,0,8,0,3,0,1,1,0,2,2,5
Punjab,"11 - Indecent Representation of Women (Prohibition) Act, 1986",2014,0,0,1,1,1,0,0,0,0,0,0,0,0,0,0,0,1,4,0,0,0,4,0,0,0,0,0,0,0,0,4
Punjab,12 - Commission of Sati Prevention Act 1987,2014,0,0,0,0,0,0,0,0,0,0,0,0,0,0,0,0,0,0,0,0,0,0,0,0,0,0,0,0,0,0,0
Punjab,"13 - Protection of Women from Domestic Violence Act, 2005",2014,1,0,2,2,2,0,0,0,0,0,0,0,0,0,0,0,3,0,0,0,0,0,0,0,0,0,0,0,0,0,0
Punjab,14 - Immoral Traffic (Prevention) Act (Women Cases only),2014,49,0,63,63,91,0,0,0,1,0,0,24,22,46,0,47,65,179,46,0,0,225,0,46,3,9,12,0,34,34,179
Punjab,14.1 - Under ITP Section 5,2014,20,0,33,33,39,0,0,0,0,0,0,11,14,25,0,25,28,51,25,0,0,76,0,21,3,3,6,0,15,15,55
Punjab,14.2 - Under ITP Section 6,2014,0,0,0,0,0,0,0,0,0,0,0,0,0,0,0,0,0,0,0,0,0,0,0,0,0,0,0,0,0,0,0
Punjab,14.3 - Under ITP Section 7,2014,0,0,0,0,0,0,0,0,0,0,0,0,0,0,0,0,0,0,0,0,0,0,0,0,0,0,0,0,0,0,0
Punjab,14.4 - Under ITP Section 8,2014,0,0,1,1,1,0,0,0,0,0,0,0,0,0,0,0,1,0,0,0,0,0,0,0,0,0,0,0,0,0,0
Punjab,14.5 - Other Sections under ITP Act,2014,29,0,29,29,51,0,0,0,1,0,0,13,8,21,0,22,36,128,21,0,0,149,0,25,0,6,6,0,19,19,124
Punjab,15 - Total Crimes against Women,2014,2892,0,5425,5425,5489,0,0,0,773,208,0,1905,1253,3158,239,4378,3939,6315,3158,0,15,9458,10,2115,167,470,637,421,1057,1478,7333
Rajasthan,1 - Rape (Section 376 IPC),2014,497,1209,2550,3759,3770,0,0,7,1585,88,3,1834,245,2079,9,3764,485,4622,2079,0,4,6697,48,957,37,325,362,59,536,595,5692
Rajasthan,1.1 - Custodial Rape,2014,0,1,2,3,3,0,0,0,2,0,0,0,0,0,0,2,1,0,0,0,0,0,0,0,0,0,0,0,0,0,0
Rajasthan,1.1.1 - Custodial_Gang Rape,2014,0,0,2,2,2,0,0,0,1,0,0,0,0,0,0,1,1,0,0,0,0,0,0,0,0,0,0,0,0,0,0
Rajasthan,1.1.2 - Custodial_Other Rape,2014,0,1,0,1,1,0,0,0,1,0,0,0,0,0,0,1,0,0,0,0,0,0,0,0,0,0,0,0,0,0,0
Rajasthan,1.2 - Rape other than Custodial,2014,497,1208,2548,3756,3767,0,0,7,1583,88,3,1834,245,2079,9,3762,484,4622,2079,0,4,6697,48,957,37,325,362,59,536,595,5692
Rajasthan,1.2.1 - Rape_Gang Rape,2014,66,105,309,414,416,0,0,0,230,4,0,133,22,155,0,389,91,194,155,0,0,349,0,38,0,18,18,1,19,20,311
Rajasthan,1.2.2 - Rape_Others,2014,431,1103,2239,3342,3351,0,0,7,1353,84,3,1701,223,1924,9,3373,393,4428,1924,0,4,6348,48,919,37,307,344,58,517,575,5381
Rajasthan,2 - Attempt to commit Rape (Section 376 & 511 IPC),2014,25,156,217,373,373,0,0,0,154,6,4,189,16,205,0,369,29,162,205,0,0,367,0,61,1,23,24,3,34,37,306
Rajasthan,"3 - Kidnapping & Abduction of Women (Section 363,364,364A, 366-369 IPC)",2014,759,843,3578,4421,4452,0,0,4,1538,1351,27,1144,235,1379,147,4442,734,5077,1379,0,10,6446,35,676,31,212,243,29,404,433,5735
Rajasthan,3.1 - Kidnaping & Abduction Section 363 IPC,2014,157,96,961,1057,1059,0,0,1,275,422,1,282,36,318,27,1043,170,1006,318,0,3,1321,5,100,0,41,41,0,59,59,1216
Rajasthan,3.2 - Kidnaping & Abduction in order to Murder Section 364 IPC,2014,27,13,75,88,88,0,0,0,34,34,0,30,0,30,2,100,15,167,30,0,0,197,0,17,9,0,9,8,0,8,180
Rajasthan,3.3 - Kidnapping for Ransom Section 364A,2014,0,0,0,0,0,0,0,0,0,0,0,0,0,0,0,0,0,0,0,0,0,0,0,0,0,0,0,0,0,0,0
Rajasthan,3.4 - Kidnapping & Abduction of Women to compel her for marriage,2014,341,554,1806,2360,2365,0,0,2,888,651,7,629,124,753,70,2369,330,3219,753,0,7,3965,6,399,22,125,147,19,233,252,3560
Rajasthan,3.5 - Kidnapping & Abduction of Women-Other,2014,234,180,736,916,940,0,0,1,341,244,19,203,75,278,48,930,219,685,278,0,0,963,24,160,0,46,46,2,112,114,779
Rajasthan,4 - Dowry Deaths (Section 304-B IPC),2014,91,37,371,408,410,0,0,1,88,26,2,258,61,319,0,435,63,1981,319,0,4,2296,10,339,8,126,134,4,201,205,1947
Rajasthan,5 - Assault on Women with intent to outrage her Modesty_Total (Section 354 IPC),2014,244,1705,4294,5999,6015,0,0,1,2152,285,45,3348,149,3497,22,6001,241,10258,3497,3,93,13659,375,1909,108,859,967,91,851,942,11375
Rajasthan,5.1 - Sexual Harassment,2014,23,246,481,727,727,0,0,0,220,34,10,436,22,458,5,727,23,579,458,0,7,1030,68,180,0,95,95,0,85,85,782
Rajasthan,5.2 - Assault on women with intent to Disrobe,2014,5,59,176,235,239,0,0,0,78,11,4,133,4,137,0,230,10,71,137,0,4,204,0,18,1,3,4,1,13,14,186
Rajasthan,5.3 - Voyeurism,2014,0,4,19,23,23,0,0,0,7,2,0,13,0,13,0,22,1,7,13,0,0,20,0,3,0,3,3,0,0,0,17
Rajasthan,5.4 - Stalking,2014,5,7,81,88,88,0,0,0,10,13,0,54,5,59,0,82,11,65,59,0,0,124,0,0,0,0,0,0,0,0,124
Rajasthan,5.5 - Others,2014,211,1389,3537,4926,4938,0,0,1,1837,225,31,2712,118,2830,17,4940,196,9536,2830,3,82,12281,307,1708,107,758,865,90,753,843,10266
Rajasthan,6 - Insult to the Modesty of Women_Total (Section 509 IPC),2014,0,1,17,18,18,0,0,0,2,5,0,10,0,10,1,18,0,94,10,0,0,104,0,14,0,5,5,1,8,9,90
Rajasthan,6.1 - At Office premises,2014,0,0,0,0,0,0,0,0,0,0,0,0,0,0,0,0,0,0,0,0,0,0,0,0,0,0,0,0,0,0,0
Rajasthan,6.2 - Other places related to work,2014,0,0,0,0,0,0,0,0,0,0,0,0,0,0,0,0,0,0,0,0,0,0,0,0,0,0,0,0,0,0,0
Rajasthan,6.3 - In Public Transport system,2014,0,0,2,2,2,0,0,0,0,0,0,1,0,1,1,2,0,5,1,0,0,6,0,1,0,0,0,0,1,1,5
Rajasthan,6.4 - in Other Places,2014,0,1,15,16,16,0,0,0,2,5,0,9,0,9,0,16,0,89,9,0,0,98,0,13,0,5,5,1,7,8,85
Rajasthan,7 - Cruelty by Husband or his Relatives (Section 498A),2014,1239,11411,4494,15905,15956,0,0,18,5098,2106,56,8012,727,8739,5,16004,1122,30287,8739,0,355,38671,1005,4858,147,1664,1811,216,2831,3047,32808
Rajasthan,8 - Importation of Girls from Foreign Country (Section 366B IPC),2014,0,0,0,0,0,0,0,0,0,0,0,0,0,0,0,0,0,2,0,0,0,2,0,2,0,1,1,0,1,1,0
Rajasthan,9 - Abetment of Suicides of Women u/s 306 IPC,2014,13,4,139,143,143,0,0,0,30,8,0,92,4,96,2,136,20,80,96,0,0,176,0,19,3,6,9,3,7,10,157
Rajasthan,"10 - Dowry Prohibition Act, 1961",2014,3,2,10,12,12,0,0,0,6,4,0,3,0,3,0,13,2,38,3,0,0,41,0,3,0,2,2,0,1,1,38
Rajasthan,"11 - Indecent Representation of Women (Prohibition) Act, 1986",2014,3,0,18,18,18,0,0,0,0,1,0,18,2,20,0,21,0,627,20,0,0,647,0,133,1,74,75,0,58,58,514
Rajasthan,12 - Commission of Sati Prevention Act 1987,2014,0,0,0,0,0,0,0,0,0,0,0,0,0,0,0,0,0,1,0,0,0,1,0,1,0,0,0,0,1,1,0
Rajasthan,"13 - Protection of Women from Domestic Violence Act, 2005",2014,0,9,8,17,17,0,0,0,5,1,0,11,0,11,0,17,0,10,11,0,0,21,0,0,0,0,0,0,0,0,21
Rajasthan,14 - Immoral Traffic (Prevention) Act (Women Cases only),2014,7,0,78,78,102,0,0,0,0,0,0,61,3,64,0,64,21,429,64,0,1,492,0,32,1,25,26,0,6,6,460
Rajasthan,14.1 - Under ITP Section 5,2014,2,0,18,18,20,0,0,0,0,0,0,13,0,13,0,13,7,119,13,0,0,132,0,7,0,6,6,0,1,1,125
Rajasthan,14.2 - Under ITP Section 6,2014,0,0,8,8,8,0,0,0,0,0,0,7,0,7,0,7,1,21,7,0,0,28,0,0,0,0,0,0,0,0,28
Rajasthan,14.3 - Under ITP Section 7,2014,0,0,0,0,0,0,0,0,0,0,0,0,0,0,0,0,0,0,0,0,0,0,0,0,0,0,0,0,0,0,0
Rajasthan,14.4 - Under ITP Section 8,2014,0,0,1,1,1,0,0,0,0,0,0,0,0,0,0,0,1,0,0,0,0,0,0,0,0,0,0,0,0,0,0
Rajasthan,14.5 - Other Sections under ITP Act,2014,5,0,51,51,73,0,0,0,0,0,0,41,3,44,0,44,12,289,44,0,1,332,0,25,1,19,20,0,5,5,307
Rajasthan,15 - Total Crimes against Women,2014,2881,15377,15774,31151,31286,0,0,31,10658,3881,137,14980,1442,16422,186,31284,2717,53668,16422,3,467,69620,1473,9004,337,3322,3659,406,4939,5345,59143
Sikkim,1 - Rape (Section 376 IPC),2014,5,0,47,47,54,0,0,0,0,0,0,38,5,43,1,44,8,68,43,0,0,111,0,39,2,20,22,2,15,17,72
Sikkim,1.1 - Custodial Rape,2014,0,0,0,0,0,0,0,0,0,0,0,0,0,0,0,0,0,0,0,0,0,0,0,0,0,0,0,0,0,0,0
Sikkim,1.1.1 - Custodial_Gang Rape,2014,0,0,0,0,0,0,0,0,0,0,0,0,0,0,0,0,0,0,0,0,0,0,0,0,0,0,0,0,0,0,0
Sikkim,1.1.2 - Custodial_Other Rape,2014,0,0,0,0,0,0,0,0,0,0,0,0,0,0,0,0,0,0,0,0,0,0,0,0,0,0,0,0,0,0,0
Sikkim,1.2 - Rape other than Custodial,2014,5,0,47,47,54,0,0,0,0,0,0,38,5,43,1,44,8,68,43,0,0,111,0,39,2,20,22,2,15,17,72
Sikkim,1.2.1 - Rape_Gang Rape,2014,0,0,1,1,1,0,0,0,0,0,0,1,0,1,0,1,0,0,1,0,0,1,0,0,0,0,0,0,0,0,1
Sikkim,1.2.2 - Rape_Others,2014,5,0,46,46,53,0,0,0,0,0,0,37,5,42,1,43,8,68,42,0,0,110,0,39,2,20,22,2,15,17,71
Sikkim,2 - Attempt to commit Rape (Section 376 & 511 IPC),2014,0,0,9,9,9,0,0,0,0,0,0,8,0,8,0,8,1,0,8,0,0,8,0,2,0,0,0,2,0,2,6
Sikkim,"3 - Kidnapping & Abduction of Women (Section 363,364,364A, 366-369 IPC)",2014,6,0,12,12,15,0,0,0,0,0,0,6,6,12,0,12,6,8,12,0,0,20,0,8,0,2,2,0,6,6,12
Sikkim,3.1 - Kidnaping & Abduction Section 363 IPC,2014,0,0,9,9,11,0,0,0,0,0,0,5,0,5,0,5,4,0,5,0,0,5,0,0,0,0,0,0,0,0,5
Sikkim,3.2 - Kidnaping & Abduction in order to Murder Section 364 IPC,2014,0,0,0,0,0,0,0,0,0,0,0,0,0,0,0,0,0,0,0,0,0,0,0,0,0,0,0,0,0,0,0
Sikkim,3.3 - Kidnapping for Ransom Section 364A,2014,0,0,0,0,0,0,0,0,0,0,0,0,0,0,0,0,0,0,0,0,0,0,0,0,0,0,0,0,0,0,0
Sikkim,3.4 - Kidnapping & Abduction of Women to compel her for marriage,2014,0,0,0,0,0,0,0,0,0,0,0,0,0,0,0,0,0,0,0,0,0,0,0,0,0,0,0,0,0,0,0
Sikkim,3.5 - Kidnapping & Abduction of Women-Other,2014,6,0,3,3,4,0,0,0,0,0,0,1,6,7,0,7,2,8,7,0,0,15,0,8,0,2,2,0,6,6,7
Sikkim,4 - Dowry Deaths (Section 304-B IPC),2014,0,0,0,0,0,0,0,0,0,0,0,0,0,0,0,0,0,0,0,0,0,0,0,0,0,0,0,0,0,0,0
Sikkim,5 - Assault on Women with intent to outrage her Modesty_Total (Section 354 IPC),2014,8,0,34,34,39,0,0,0,0,0,0,27,8,35,2,37,5,22,35,0,0,57,1,26,2,16,18,2,6,8,30
Sikkim,5.1 - Sexual Harassment,2014,0,0,14,14,18,0,0,0,0,0,0,14,0,14,0,14,0,0,14,0,0,14,1,1,1,0,1,0,0,0,12
Sikkim,5.2 - Assault on women with intent to Disrobe,2014,0,0,1,1,1,0,0,0,0,0,0,0,0,0,0,0,1,0,0,0,0,0,0,0,0,0,0,0,0,0,0
Sikkim,5.3 - Voyeurism,2014,0,0,0,0,0,0,0,0,0,0,0,0,0,0,0,0,0,0,0,0,0,0,0,0,0,0,0,0,0,0,0
Sikkim,5.4 - Stalking,2014,0,0,2,2,2,0,0,0,0,0,0,2,0,2,0,2,0,0,2,0,0,2,0,0,0,0,0,0,0,0,2
Sikkim,5.5 - Others,2014,8,0,17,17,18,0,0,0,0,0,0,11,8,19,2,21,4,22,19,0,0,41,0,25,1,16,17,2,6,8,16
Sikkim,6 - Insult to the Modesty of Women_Total (Section 509 IPC),2014,0,0,3,3,3,0,0,0,0,0,0,1,0,1,0,1,2,0,1,0,0,1,0,0,0,0,0,0,0,0,1
Sikkim,6.1 - At Office premises,2014,0,0,0,0,0,0,0,0,0,0,0,0,0,0,0,0,0,0,0,0,0,0,0,0,0,0,0,0,0,0,0
Sikkim,6.2 - Other places related to work,2014,0,0,0,0,0,0,0,0,0,0,0,0,0,0,0,0,0,0,0,0,0,0,0,0,0,0,0,0,0,0,0
Sikkim,6.3 - In Public Transport system,2014,0,0,0,0,0,0,0,0,0,0,0,0,0,0,0,0,0,0,0,0,0,0,0,0,0,0,0,0,0,0,0
Sikkim,6.4 - in Other Places,2014,0,0,3,3,3,0,0,0,0,0,0,1,0,1,0,1,2,0,1,0,0,1,0,0,0,0,0,0,0,0,1
Sikkim,7 - Cruelty by Husband or his Relatives (Section 498A),2014,2,0,5,5,5,0,0,0,0,0,0,2,2,4,0,4,3,6,4,0,0,10,0,6,0,4,4,0,2,2,4
Sikkim,8 - Importation of Girls from Foreign Country (Section 366B IPC),2014,0,0,0,0,0,0,0,0,0,0,0,0,0,0,0,0,0,0,0,0,0,0,0,0,0,0,0,0,0,0,0
Sikkim,9 - Abetment of Suicides of Women u/s 306 IPC,2014,0,0,0,0,0,0,0,0,0,0,0,0,0,0,0,0,0,0,0,0,0,0,0,0,0,0,0,0,0,0,0
Sikkim,"10 - Dowry Prohibition Act, 1961",2014,0,0,0,0,0,0,0,0,0,0,0,0,0,0,0,0,0,0,0,0,0,0,0,0,0,0,0,0,0,0,0
Sikkim,"11 - Indecent Representation of Women (Prohibition) Act, 1986",2014,0,0,0,0,0,0,0,0,0,0,0,0,0,0,0,0,0,0,0,0,0,0,0,0,0,0,0,0,0,0,0
Sikkim,12 - Commission of Sati Prevention Act 1987,2014,0,0,0,0,0,0,0,0,0,0,0,0,0,0,0,0,0,0,0,0,0,0,0,0,0,0,0,0,0,0,0
Sikkim,"13 - Protection of Women from Domestic Violence Act, 2005",2014,0,0,0,0,0,0,0,0,0,0,0,0,0,0,0,0,0,0,0,0,0,0,0,0,0,0,0,0,0,0,0
Sikkim,14 - Immoral Traffic (Prevention) Act (Women Cases only),2014,0,0,0,0,0,0,0,0,0,0,0,0,0,0,0,0,0,0,0,0,0,0,0,0,0,0,0,0,0,0,0
Sikkim,14.1 - Under ITP Section 5,2014,0,0,0,0,0,0,0,0,0,0,0,0,0,0,0,0,0,0,0,0,0,0,0,0,0,0,0,0,0,0,0
Sikkim,14.2 - Under ITP Section 6,2014,0,0,0,0,0,0,0,0,0,0,0,0,0,0,0,0,0,0,0,0,0,0,0,0,0,0,0,0,0,0,0
Sikkim,14.3 - Under ITP Section 7,2014,0,0,0,0,0,0,0,0,0,0,0,0,0,0,0,0,0,0,0,0,0,0,0,0,0,0,0,0,0,0,0
Sikkim,14.4 - Under ITP Section 8,2014,0,0,0,0,0,0,0,0,0,0,0,0,0,0,0,0,0,0,0,0,0,0,0,0,0,0,0,0,0,0,0
Sikkim,14.5 - Other Sections under ITP Act,2014,0,0,0,0,0,0,0,0,0,0,0,0,0,0,0,0,0,0,0,0,0,0,0,0,0,0,0,0,0,0,0
Sikkim,15 - Total Crimes against Women,2014,21,0,110,110,125,0,0,0,0,0,0,82,21,103,3,106,25,104,103,0,0,207,1,81,4,42,46,6,29,35,125
Tamil Nadu,1 - Rape (Section 376 IPC),2014,589,4,451,455,459,0,0,5,3,12,1,237,337,574,24,614,425,2422,574,0,0,2996,1,577,2,155,157,4,416,420,2418
Tamil Nadu,1.1 - Custodial Rape,2014,0,0,0,0,0,0,0,0,0,0,0,0,0,0,0,0,0,0,0,0,0,0,0,0,0,0,0,0,0,0,0
Tamil Nadu,1.1.1 - Custodial_Gang Rape,2014,0,0,0,0,0,0,0,0,0,0,0,0,0,0,0,0,0,0,0,0,0,0,0,0,0,0,0,0,0,0,0
Tamil Nadu,1.1.2 - Custodial_Other Rape,2014,0,0,0,0,0,0,0,0,0,0,0,0,0,0,0,0,0,0,0,0,0,0,0,0,0,0,0,0,0,0,0
Tamil Nadu,1.2 - Rape other than Custodial,2014,589,4,451,455,459,0,0,5,3,12,1,237,337,574,24,614,425,2422,574,0,0,2996,1,577,2,155,157,4,416,420,2418
Tamil Nadu,1.2.1 - Rape_Gang Rape,2014,0,0,2,2,2,0,0,0,0,0,0,1,0,1,0,1,1,0,1,0,0,1,0,0,0,0,0,0,0,0,1
Tamil Nadu,1.2.2 - Rape_Others,2014,589,4,449,453,457,0,0,5,3,12,1,236,337,573,24,613,424,2422,573,0,0,2995,1,577,2,155,157,4,416,420,2417
Tamil Nadu,2 - Attempt to commit Rape (Section 376 & 511 IPC),2014,15,0,16,16,16,0,0,0,0,1,0,6,9,15,1,17,14,23,15,0,0,38,0,4,0,0,0,0,4,4,34
Tamil Nadu,"3 - Kidnapping & Abduction of Women (Section 363,364,364A, 366-369 IPC)",2014,1108,9,1493,1502,1515,0,0,16,48,342,65,288,372,660,363,1478,1116,1390,660,0,0,2050,18,546,7,90,97,19,430,449,1486
Tamil Nadu,3.1 - Kidnaping & Abduction Section 363 IPC,2014,209,1,230,231,233,0,0,6,4,26,0,69,79,148,94,272,162,217,148,0,0,365,13,108,0,2,2,1,105,106,244
Tamil Nadu,3.2 - Kidnaping & Abduction in order to Murder Section 364 IPC,2014,0,0,0,0,0,0,0,0,0,0,0,0,0,0,0,0,0,0,0,0,0,0,0,0,0,0,0,0,0,0,0
Tamil Nadu,3.3 - Kidnapping for Ransom Section 364A,2014,0,0,1,1,1,0,0,0,0,0,0,0,0,0,0,0,1,0,0,0,0,0,0,0,0,0,0,0,0,0,0
Tamil Nadu,3.4 - Kidnapping & Abduction of Women to compel her for marriage,2014,782,7,1073,1080,1087,0,0,10,44,306,65,173,260,433,224,1072,780,1090,433,0,0,1523,5,412,7,86,93,16,303,319,1106
Tamil Nadu,3.5 - Kidnapping & Abduction of Women-Other,2014,117,1,189,190,194,0,0,0,0,10,0,46,33,79,45,134,173,83,79,0,0,162,0,26,0,2,2,2,22,24,136
Tamil Nadu,4 - Dowry Deaths (Section 304-B IPC),2014,125,0,95,95,95,0,0,0,0,0,0,50,93,143,0,143,77,571,143,0,0,714,0,158,0,45,45,1,112,113,556
Tamil Nadu,5 - Assault on Women with intent to outrage her Modesty_Total (Section 354 IPC),2014,587,12,1090,1102,1102,0,0,0,15,126,9,587,313,900,48,1098,591,3495,900,0,0,4395,0,1102,43,267,310,19,773,792,3293
Tamil Nadu,5.1 - Sexual Harassment,2014,37,1,45,46,46,0,0,0,1,4,0,18,21,39,2,46,37,133,39,0,0,172,0,55,2,22,24,1,30,31,117
Tamil Nadu,5.2 - Assault on women with intent to Disrobe,2014,26,2,69,71,71,0,0,0,0,4,0,54,20,74,0,78,19,65,74,0,0,139,0,15,0,1,1,1,13,14,124
Tamil Nadu,5.3 - Voyeurism,2014,0,0,1,1,1,0,0,0,0,0,0,0,0,0,0,0,1,0,0,0,0,0,0,0,0,0,0,0,0,0,0
Tamil Nadu,5.4 - Stalking,2014,0,0,1,1,1,0,0,0,0,0,0,0,0,0,0,0,1,0,0,0,0,0,0,0,0,0,0,0,0,0,0
Tamil Nadu,5.5 - Others,2014,524,9,974,983,983,0,0,0,14,118,9,515,272,787,46,974,533,3297,787,0,0,4084,0,1032,41,244,285,17,730,747,3052
Tamil Nadu,6 - Insult to the Modesty of Women_Total (Section 509 IPC),2014,168,1,228,229,229,0,0,0,0,0,0,84,118,202,8,210,187,723,202,0,0,925,0,250,12,112,124,11,115,126,675
Tamil Nadu,6.1 - At Office premises,2014,0,0,2,2,2,0,0,0,0,0,0,2,0,2,0,2,0,0,2,0,0,2,0,0,0,0,0,0,0,0,2
Tamil Nadu,6.2 - Other places related to work,2014,91,1,156,157,157,0,0,0,0,0,0,34,70,104,7,111,137,336,104,0,0,440,0,119,5,46,51,11,57,68,321
Tamil Nadu,6.3 - In Public Transport system,2014,0,0,0,0,0,0,0,0,0,0,0,0,0,0,0,0,0,0,0,0,0,0,0,0,0,0,0,0,0,0,0
Tamil Nadu,6.4 - in Other Places,2014,77,0,70,70,70,0,0,0,0,0,0,48,48,96,1,97,50,387,96,0,0,483,0,131,7,66,73,0,58,58,352
Tamil Nadu,7 - Cruelty by Husband or his Relatives (Section 498A),2014,1357,132,1971,2103,2103,0,0,38,43,146,0,1000,619,1619,121,1929,1493,5001,1619,0,0,6620,3,1442,29,151,180,69,1193,1262,5175
Tamil Nadu,8 - Importation of Girls from Foreign Country (Section 366B IPC),2014,0,0,0,0,0,0,0,0,0,0,0,0,0,0,0,0,0,0,0,0,0,0,0,0,0,0,0,0,0,0,0
Tamil Nadu,9 - Abetment of Suicides of Women u/s 306 IPC,2014,0,0,52,52,52,0,0,0,0,0,0,16,0,16,2,18,34,0,16,0,0,16,0,0,0,0,0,0,0,0,16
Tamil Nadu,"10 - Dowry Prohibition Act, 1961",2014,86,37,255,292,292,0,0,12,2,13,0,144,66,210,20,245,121,619,210,0,0,829,0,236,0,70,70,11,155,166,593
Tamil Nadu,"11 - Indecent Representation of Women (Prohibition) Act, 1986",2014,4,0,4,4,4,0,0,0,0,0,0,0,0,0,0,0,8,5,0,0,0,5,0,2,0,0,0,0,2,2,3
Tamil Nadu,12 - Commission of Sati Prevention Act 1987,2014,0,0,0,0,0,0,0,0,0,0,0,0,0,0,0,0,0,0,0,0,0,0,0,0,0,0,0,0,0,0,0
Tamil Nadu,"13 - Protection of Women from Domestic Violence Act, 2005",2014,0,0,4,4,4,0,0,0,0,0,0,3,0,3,0,3,1,0,3,0,0,3,0,1,0,0,0,1,0,1,2
Tamil Nadu,14 - Immoral Traffic (Prevention) Act (Women Cases only),2014,29,0,471,471,541,0,0,0,0,0,0,392,16,408,1,409,91,217,408,0,0,625,0,248,175,27,202,19,27,46,377
Tamil Nadu,14.1 - Under ITP Section 5,2014,15,0,94,94,120,0,0,0,0,0,0,84,5,89,0,89,20,91,89,0,0,180,0,28,9,10,19,1,8,9,152
Tamil Nadu,14.2 - Under ITP Section 6,2014,0,0,2,2,3,0,0,0,0,0,0,2,0,2,0,2,0,0,2,0,0,2,0,1,1,0,1,0,0,0,1
Tamil Nadu,14.3 - Under ITP Section 7,2014,0,0,0,0,0,0,0,0,0,0,0,0,0,0,0,0,0,1,0,0,0,1,0,0,0,0,0,0,0,0,1
Tamil Nadu,14.4 - Under ITP Section 8,2014,0,0,19,19,19,0,0,0,0,0,0,13,0,13,0,13,6,8,13,0,0,21,0,3,2,0,2,0,1,1,18
Tamil Nadu,14.5 - Other Sections under ITP Act,2014,14,0,356,356,399,0,0,0,0,0,0,293,11,304,1,305,65,117,304,0,0,421,0,216,163,17,180,18,18,36,205
Tamil Nadu,15 - Total Crimes against Women,2014,4068,195,6130,6325,6412,0,0,71,111,640,75,2807,1943,4750,588,6164,4158,14466,4750,0,0,19216,22,4566,268,917,1185,154,3227,3381,14628
Telangana,1 - Rape (Section 376 IPC),2014,614,8,971,979,979,0,0,7,39,4,0,414,427,841,23,907,679,1655,841,0,0,2496,2,414,5,44,49,40,325,365,2080
Telangana,1.1 - Custodial Rape,2014,0,0,0,0,0,0,0,0,0,0,0,0,0,0,0,0,0,0,0,0,0,0,0,0,0,0,0,0,0,0,0
Telangana,1.1.1 - Custodial_Gang Rape,2014,0,0,0,0,0,0,0,0,0,0,0,0,0,0,0,0,0,0,0,0,0,0,0,0,0,0,0,0,0,0,0
Telangana,1.1.2 - Custodial_Other Rape,2014,0,0,0,0,0,0,0,0,0,0,0,0,0,0,0,0,0,0,0,0,0,0,0,0,0,0,0,0,0,0,0
Telangana,1.2 - Rape other than Custodial,2014,614,8,971,979,979,0,0,7,39,4,0,414,427,841,23,907,679,1655,841,0,0,2496,2,414,5,44,49,40,325,365,2080
Telangana,1.2.1 - Rape_Gang Rape,2014,4,0,14,14,14,0,0,0,0,0,0,7,4,11,0,11,7,1,11,0,0,12,0,1,0,0,0,1,0,1,11
Telangana,1.2.2 - Rape_Others,2014,610,8,957,965,965,0,0,7,39,4,0,407,423,830,23,896,672,1654,830,0,0,2484,2,413,5,44,49,39,325,364,2069
Telangana,2 - Attempt to commit Rape (Section 376 & 511 IPC),2014,30,0,73,73,73,0,0,0,4,0,0,55,30,85,0,89,14,38,85,0,0,123,10,45,0,6,6,4,35,39,68
Telangana,"3 - Kidnapping & Abduction of Women (Section 363,364,364A, 366-369 IPC)",2014,238,5,706,711,769,0,0,8,106,62,4,279,97,376,65,613,328,1278,376,0,0,1654,14,317,7,18,25,62,230,292,1323
Telangana,3.1 - Kidnaping & Abduction Section 363 IPC,2014,25,1,242,243,247,0,0,0,30,22,0,88,8,96,42,190,78,230,96,0,0,326,5,59,5,2,7,6,46,52,262
Telangana,3.2 - Kidnaping & Abduction in order to Murder Section 364 IPC,2014,0,0,0,0,0,0,0,0,0,0,0,0,0,0,0,0,0,13,0,0,0,13,0,0,0,0,0,0,0,0,13
Telangana,3.3 - Kidnapping for Ransom Section 364A,2014,2,0,2,2,2,0,0,0,0,0,0,1,2,3,0,3,1,15,3,0,0,18,0,0,0,0,0,0,0,0,18
Telangana,3.4 - Kidnapping & Abduction of Women to compel her for marriage,2014,152,2,245,247,247,0,0,0,49,11,4,105,60,165,7,236,163,682,165,0,0,847,6,142,2,8,10,42,90,132,699
Telangana,3.5 - Kidnapping & Abduction of Women-Other,2014,59,2,217,219,273,0,0,8,27,29,0,85,27,112,16,184,86,338,112,0,0,450,3,116,0,8,8,14,94,108,331
Telangana,4 - Dowry Deaths (Section 304-B IPC),2014,163,0,289,289,290,0,0,0,5,1,0,170,112,282,2,290,162,759,282,0,0,1041,0,247,5,32,37,25,185,210,794
Telangana,5 - Assault on Women with intent to outrage her Modesty_Total (Section 354 IPC),2014,979,56,3132,3188,3203,0,0,2,167,33,0,1898,472,2370,39,2609,1556,3733,2370,0,1,6102,229,1117,16,84,100,161,856,1017,4756
Telangana,5.1 - Sexual Harassment,2014,106,6,614,620,620,0,0,2,38,4,0,426,58,484,5,531,193,311,484,0,1,794,64,152,2,24,26,64,62,126,578
Telangana,5.2 - Assault on women with intent to Disrobe,2014,19,2,174,176,176,0,0,0,12,0,0,132,7,139,4,155,40,76,139,0,0,215,6,29,1,0,1,13,15,28,180
Telangana,5.3 - Voyeurism,2014,4,0,45,45,45,0,0,0,1,0,0,23,6,29,1,31,18,16,29,0,0,45,4,7,0,0,0,3,4,7,34
Telangana,5.4 - Stalking,2014,38,2,424,426,427,0,0,0,17,3,0,301,45,346,5,371,93,176,346,0,0,522,29,28,1,2,3,17,8,25,465
Telangana,5.5 - Others,2014,812,46,1875,1921,1935,0,0,0,99,26,0,1016,356,1372,24,1521,1212,3154,1372,0,0,4526,126,901,12,58,70,64,767,831,3499
Telangana,6 - Insult to the Modesty of Women_Total (Section 509 IPC),2014,307,6,1136,1142,1144,0,0,0,61,4,0,851,206,1057,57,1179,270,1488,1057,0,16,2529,368,519,14,100,114,93,312,405,1642
Telangana,6.1 - At Office premises,2014,1,0,5,5,5,0,0,0,0,0,0,2,0,2,0,2,4,0,2,0,0,2,0,0,0,0,0,0,0,0,2
Telangana,6.2 - Other places related to work,2014,37,0,43,43,43,0,0,0,1,0,0,21,16,37,17,55,25,107,37,0,0,144,17,23,0,5,5,0,18,18,104
Telangana,6.3 - In Public Transport system,2014,1,0,3,3,3,0,0,0,1,0,0,3,0,3,0,4,0,2,3,0,0,5,2,1,0,0,0,1,0,1,2
Telangana,6.4 - in Other Places,2014,268,6,1085,1091,1093,0,0,0,59,4,0,825,190,1015,40,1118,241,1379,1015,0,16,2378,349,495,14,95,109,92,294,386,1534
Telangana,7 - Cruelty by Husband or his Relatives (Section 498A),2014,3490,734,5635,6369,6392,0,0,16,700,152,7,3318,1974,5292,474,6625,3218,12981,5292,0,14,18259,2147,2633,22,136,158,169,2306,2475,13479
Telangana,8 - Importation of Girls from Foreign Country (Section 366B IPC),2014,0,0,0,0,0,0,0,0,0,0,0,0,0,0,0,0,0,1,0,0,0,1,0,0,0,0,0,0,0,0,1
Telangana,9 - Abetment of Suicides of Women u/s 306 IPC,2014,42,0,627,627,627,0,0,1,7,2,9,156,32,188,0,206,462,249,188,0,0,437,0,90,0,2,2,5,83,88,347
Telangana,"10 - Dowry Prohibition Act, 1961",2014,396,0,563,563,563,0,0,0,15,9,0,373,345,718,0,742,217,1138,718,0,0,1856,327,388,0,8,8,4,376,380,1141
Telangana,"11 - Indecent Representation of Women (Prohibition) Act, 1986",2014,0,0,2,2,2,0,0,0,0,0,0,2,0,2,0,2,0,6,2,0,0,8,0,2,0,0,0,0,2,2,6
Telangana,12 - Commission of Sati Prevention Act 1987,2014,0,0,0,0,0,0,0,0,0,0,0,0,0,0,0,0,0,0,0,0,0,0,0,0,0,0,0,0,0,0,0
Telangana,"13 - Protection of Women from Domestic Violence Act, 2005",2014,1,0,1,1,1,0,0,0,0,0,0,1,0,1,0,1,1,0,1,0,0,1,0,0,0,0,0,0,0,0,1
Telangana,14 - Immoral Traffic (Prevention) Act (Women Cases only),2014,34,0,192,192,216,0,0,0,0,0,0,124,27,151,0,151,75,143,151,0,0,294,0,53,0,5,5,6,42,48,241
Telangana,14.1 - Under ITP Section 5,2014,20,0,82,82,84,0,0,0,0,0,0,47,20,67,0,67,35,31,67,0,0,98,0,16,0,2,2,3,11,14,82
Telangana,14.2 - Under ITP Section 6,2014,0,0,29,29,43,0,0,0,0,0,0,27,0,27,0,27,2,12,27,0,0,39,0,2,0,0,0,0,2,2,37
Telangana,14.3 - Under ITP Section 7,2014,1,0,8,8,8,0,0,0,0,0,0,6,1,7,0,7,2,1,7,0,0,8,0,3,0,0,0,1,2,3,5
Telangana,14.4 - Under ITP Section 8,2014,0,0,0,0,0,0,0,0,0,0,0,0,0,0,0,0,0,0,0,0,0,0,0,0,0,0,0,0,0,0,0
Telangana,14.5 - Other Sections under ITP Act,2014,13,0,73,73,81,0,0,0,0,0,0,44,6,50,0,50,36,99,50,0,0,149,0,32,0,3,3,2,27,29,117
Telangana,15 - Total Crimes against Women,2014,6294,809,13327,14136,14259,0,0,34,1104,267,20,7641,3722,11363,660,13414,6982,23469,11363,0,31,34801,3097,5825,69,435,504,569,4752,5321,25879
Tripura,1 - Rape (Section 376 IPC),2014,64,24,215,239,245,0,0,0,6,8,0,135,56,191,9,214,89,460,191,0,1,650,23,99,3,27,30,3,66,69,528
Tripura,1.1 - Custodial Rape,2014,0,0,0,0,0,0,0,0,0,0,0,0,0,0,0,0,0,0,0,0,0,0,0,0,0,0,0,0,0,0,0
Tripura,1.1.1 - Custodial_Gang Rape,2014,0,0,0,0,0,0,0,0,0,0,0,0,0,0,0,0,0,0,0,0,0,0,0,0,0,0,0,0,0,0,0
Tripura,1.1.2 - Custodial_Other Rape,2014,0,0,0,0,0,0,0,0,0,0,0,0,0,0,0,0,0,0,0,0,0,0,0,0,0,0,0,0,0,0,0
Tripura,1.2 - Rape other than Custodial,2014,64,24,215,239,245,0,0,0,6,8,0,135,56,191,9,214,89,460,191,0,1,650,23,99,3,27,30,3,66,69,528
Tripura,1.2.1 - Rape_Gang Rape,2014,2,0,15,15,18,0,0,0,0,0,0,12,2,14,0,14,3,22,14,0,0,36,4,4,0,2,2,0,2,2,28
Tripura,1.2.2 - Rape_Others,2014,62,24,200,224,227,0,0,0,6,8,0,123,54,177,9,200,86,438,177,0,1,614,19,95,3,25,28,3,64,67,500
Tripura,2 - Attempt to commit Rape (Section 376 & 511 IPC),2014,2,4,31,35,35,0,0,0,0,3,0,26,2,28,2,33,4,10,28,0,1,37,3,10,1,1,2,1,7,8,24
Tripura,"3 - Kidnapping & Abduction of Women (Section 363,364,364A, 366-369 IPC)",2014,49,2,100,102,102,0,0,3,4,28,0,37,32,69,3,104,44,148,69,0,0,217,10,22,1,1,2,0,20,20,185
Tripura,3.1 - Kidnaping & Abduction Section 363 IPC,2014,0,0,0,0,0,0,0,0,0,0,0,0,0,0,0,0,0,0,0,0,0,0,0,0,0,0,0,0,0,0,0
Tripura,3.2 - Kidnaping & Abduction in order to Murder Section 364 IPC,2014,0,0,0,0,0,0,0,0,0,0,0,0,0,0,0,0,0,0,0,0,0,0,0,0,0,0,0,0,0,0,0
Tripura,3.3 - Kidnapping for Ransom Section 364A,2014,0,0,0,0,0,0,0,0,0,0,0,0,0,0,0,0,0,0,0,0,0,0,0,0,0,0,0,0,0,0,0
Tripura,3.4 - Kidnapping & Abduction of Women to compel her for marriage,2014,42,1,78,79,79,0,0,3,2,25,0,28,27,55,2,84,34,131,55,0,0,186,10,19,1,1,2,0,17,17,157
Tripura,3.5 - Kidnapping & Abduction of Women-Other,2014,7,1,22,23,23,0,0,0,2,3,0,9,5,14,1,20,10,17,14,0,0,31,0,3,0,0,0,0,3,3,28
Tripura,4 - Dowry Deaths (Section 304-B IPC),2014,19,0,33,33,33,0,0,0,0,0,0,21,19,40,1,41,11,71,40,0,0,111,2,12,0,4,4,0,8,8,97
Tripura,5 - Assault on Women with intent to outrage her Modesty_Total (Section 354 IPC),2014,36,84,408,492,504,0,0,0,20,63,2,355,20,375,18,478,50,846,375,0,20,1201,52,175,5,15,20,9,146,155,974
Tripura,5.1 - Sexual Harassment,2014,6,9,73,82,84,0,0,0,3,6,0,62,4,66,2,77,11,33,66,0,1,98,4,16,1,4,5,4,7,11,78
Tripura,5.2 - Assault on women with intent to Disrobe,2014,0,23,161,184,184,0,0,0,8,24,0,132,0,132,5,169,15,67,132,0,3,196,20,50,4,4,8,5,37,42,126
Tripura,5.3 - Voyeurism,2014,0,0,1,1,1,0,0,0,0,1,0,0,0,0,0,1,0,0,0,0,0,0,0,0,0,0,0,0,0,0,0
Tripura,5.4 - Stalking,2014,0,0,8,8,8,0,0,0,1,0,0,6,0,6,1,8,0,15,6,0,0,21,0,14,0,1,1,0,13,13,7
Tripura,5.5 - Others,2014,30,52,165,217,227,0,0,0,8,32,2,155,16,171,10,223,24,731,171,0,16,886,28,95,0,6,6,0,89,89,763
Tripura,6 - Insult to the Modesty of Women_Total (Section 509 IPC),2014,1,1,10,11,11,0,0,0,0,4,0,5,0,5,0,9,3,5,5,0,0,10,1,2,0,0,0,1,1,2,7
Tripura,6.1 - At Office premises,2014,0,0,0,0,0,0,0,0,0,0,0,0,0,0,0,0,0,0,0,0,0,0,0,0,0,0,0,0,0,0,0
Tripura,6.2 - Other places related to work,2014,0,0,0,0,0,0,0,0,0,0,0,0,0,0,0,0,0,0,0,0,0,0,0,0,0,0,0,0,0,0,0
Tripura,6.3 - In Public Transport system,2014,0,0,0,0,0,0,0,0,0,0,0,0,0,0,0,0,0,0,0,0,0,0,0,0,0,0,0,0,0,0,0
Tripura,6.4 - in Other Places,2014,1,1,10,11,11,0,0,0,0,4,0,5,0,5,0,9,3,5,5,0,0,10,1,2,0,0,0,1,1,2,7
Tripura,7 - Cruelty by Husband or his Relatives (Section 498A),2014,60,164,538,702,731,0,0,0,3,52,0,594,39,633,14,702,60,1731,633,0,39,2325,329,288,9,40,49,34,205,239,1708
Tripura,8 - Importation of Girls from Foreign Country (Section 366B IPC),2014,0,0,0,0,0,0,0,0,0,0,0,0,0,0,0,0,0,0,0,0,0,0,0,0,0,0,0,0,0,0,0
Tripura,9 - Abetment of Suicides of Women u/s 306 IPC,2014,0,0,0,0,0,0,0,0,0,0,0,0,0,0,0,0,0,0,0,0,0,0,0,0,0,0,0,0,0,0,0
Tripura,"10 - Dowry Prohibition Act, 1961",2014,0,0,1,1,1,0,0,0,0,0,0,0,0,0,0,0,1,0,0,0,0,0,0,0,0,0,0,0,0,0,0
Tripura,"11 - Indecent Representation of Women (Prohibition) Act, 1986",2014,0,0,0,0,0,0,0,0,0,0,0,0,0,0,0,0,0,0,0,0,0,0,0,0,0,0,0,0,0,0,0
Tripura,12 - Commission of Sati Prevention Act 1987,2014,0,0,0,0,0,0,0,0,0,0,0,0,0,0,0,0,0,0,0,0,0,0,0,0,0,0,0,0,0,0,0
Tripura,"13 - Protection of Women from Domestic Violence Act, 2005",2014,0,0,0,0,0,0,0,0,0,0,0,0,0,0,0,0,0,0,0,0,0,0,0,0,0,0,0,0,0,0,0
Tripura,14 - Immoral Traffic (Prevention) Act (Women Cases only),2014,0,0,0,0,0,0,0,0,0,0,0,0,0,0,0,0,0,0,0,0,0,0,0,0,0,0,0,0,0,0,0
Tripura,14.1 - Under ITP Section 5,2014,0,0,0,0,0,0,0,0,0,0,0,0,0,0,0,0,0,0,0,0,0,0,0,0,0,0,0,0,0,0,0
Tripura,14.2 - Under ITP Section 6,2014,0,0,0,0,0,0,0,0,0,0,0,0,0,0,0,0,0,0,0,0,0,0,0,0,0,0,0,0,0,0,0
Tripura,14.3 - Under ITP Section 7,2014,0,0,0,0,0,0,0,0,0,0,0,0,0,0,0,0,0,0,0,0,0,0,0,0,0,0,0,0,0,0,0
Tripura,14.4 - Under ITP Section 8,2014,0,0,0,0,0,0,0,0,0,0,0,0,0,0,0,0,0,0,0,0,0,0,0,0,0,0,0,0,0,0,0
Tripura,14.5 - Other Sections under ITP Act,2014,0,0,0,0,0,0,0,0,0,0,0,0,0,0,0,0,0,0,0,0,0,0,0,0,0,0,0,0,0,0,0
Tripura,15 - Total Crimes against Women,2014,231,279,1336,1615,1662,0,0,3,33,158,2,1173,168,1341,47,1581,262,3271,1341,0,61,4551,420,608,19,88,107,48,453,501,3523
Uttar Pradesh,1 - Rape (Section 376 IPC),2014,422,305,3162,3467,3468,0,0,0,2,415,0,2458,392,2850,255,3522,367,5574,2850,0,11,8413,17,1183,0,594,594,5,584,589,7213
Uttar Pradesh,1.1 - Custodial Rape,2014,0,3,186,189,189,0,0,0,1,8,0,154,0,154,8,171,18,6,154,0,0,160,0,2,0,1,1,0,1,1,158
Uttar Pradesh,1.1.1 - Custodial_Gang Rape,2014,0,0,5,5,5,0,0,0,0,0,0,5,0,5,0,5,0,0,5,0,0,5,0,0,0,0,0,0,0,0,5
Uttar Pradesh,1.1.2 - Custodial_Other Rape,2014,0,3,181,184,184,0,0,0,1,8,0,149,0,149,8,166,18,6,149,0,0,155,0,2,0,1,1,0,1,1,153
Uttar Pradesh,1.2 - Rape other than Custodial,2014,422,302,2976,3278,3279,0,0,0,1,407,0,2304,392,2696,247,3351,349,5568,2696,0,11,8253,17,1181,0,593,593,5,583,588,7055
Uttar Pradesh,1.2.1 - Rape_Gang Rape,2014,27,15,558,573,574,0,0,0,0,110,0,350,27,377,39,526,74,280,377,0,0,657,0,49,0,25,25,0,24,24,608
Uttar Pradesh,1.2.2 - Rape_Others,2014,395,287,2418,2705,2705,0,0,0,1,297,0,1954,365,2319,208,2825,275,5288,2319,0,11,7596,17,1132,0,568,568,5,559,564,6447
Uttar Pradesh,2 - Attempt to commit Rape (Section 376 & 511 IPC),2014,3,48,276,324,324,0,0,0,0,32,0,209,3,212,60,304,23,63,212,0,0,275,1,14,0,8,8,0,6,6,260
Uttar Pradesh,"3 - Kidnapping & Abduction of Women (Section 363,364,364A, 366-369 IPC)",2014,2383,423,10203,10626,10628,0,0,0,11,818,0,3949,1931,5880,3829,10538,2471,13405,5880,0,77,19208,54,2455,0,1200,1200,0,1255,1255,16699
Uttar Pradesh,3.1 - Kidnaping & Abduction Section 363 IPC,2014,766,65,2556,2621,2621,0,0,0,7,195,0,831,482,1313,1178,2693,694,3228,1313,0,0,4541,27,675,0,302,302,0,373,373,3839
Uttar Pradesh,3.2 - Kidnaping & Abduction in order to Murder Section 364 IPC,2014,3,2,66,68,68,0,0,0,0,3,0,34,3,37,7,47,24,29,37,0,0,66,0,10,0,5,5,0,5,5,56
Uttar Pradesh,3.3 - Kidnapping for Ransom Section 364A,2014,0,0,1,1,1,0,0,0,0,1,0,0,0,0,0,1,0,7,0,0,0,7,0,1,0,1,1,0,0,0,6
Uttar Pradesh,3.4 - Kidnapping & Abduction of Women to compel her for marriage,2014,1579,351,6987,7338,7340,0,0,0,4,569,0,2905,1410,4315,2443,7331,1586,9840,4315,0,77,14078,27,1733,0,880,880,0,853,853,12318
Uttar Pradesh,3.5 - Kidnapping & Abduction of Women-Other,2014,35,5,593,598,598,0,0,0,0,50,0,179,36,215,201,466,167,301,215,0,0,516,0,36,0,12,12,0,24,24,480
Uttar Pradesh,4 - Dowry Deaths (Section 304-B IPC),2014,559,80,2389,2469,2473,0,0,0,2,95,0,1549,519,2068,312,2477,551,7844,2068,0,0,9912,10,1236,1,601,602,0,634,634,8666
Uttar Pradesh,5 - Assault on Women with intent to outrage her Modesty_Total (Section 354 IPC),2014,711,203,8402,8605,8615,0,0,0,2,376,0,6616,676,7292,737,8407,909,12334,7292,0,33,19593,185,2269,10,1344,1354,6,909,915,17139
Uttar Pradesh,5.1 - Sexual Harassment,2014,305,126,4309,4435,4445,0,0,0,2,203,0,3455,282,3737,369,4311,429,5126,3737,0,20,8843,68,882,4,538,542,0,340,340,7893
Uttar Pradesh,5.2 - Assault on women with intent to Disrobe,2014,28,27,1039,1066,1066,0,0,0,0,61,0,780,27,807,90,958,136,207,807,0,3,1011,3,46,3,23,26,4,16,20,962
Uttar Pradesh,5.3 - Voyeurism,2014,7,0,75,75,75,0,0,0,0,3,0,50,7,57,10,70,12,72,57,0,0,129,2,13,0,6,6,0,7,7,114
Uttar Pradesh,5.4 - Stalking,2014,66,22,813,835,835,0,0,0,0,18,0,642,60,702,73,793,108,438,702,0,0,1140,3,82,3,43,46,2,34,36,1055
Uttar Pradesh,5.5 - Others,2014,305,28,2166,2194,2194,0,0,0,0,91,0,1689,300,1989,195,2275,224,6491,1989,0,10,8470,109,1246,0,734,734,0,512,512,7115
Uttar Pradesh,6 - Insult to the Modesty of Women_Total (Section 509 IPC),2014,5,0,29,29,29,0,0,0,0,0,0,15,5,20,5,25,9,25,20,0,0,45,0,8,0,4,4,0,4,4,37
Uttar Pradesh,6.1 - At Office premises,2014,1,0,0,0,0,0,0,0,0,0,0,0,1,1,0,1,0,5,1,0,0,6,0,1,0,0,0,0,1,1,5
Uttar Pradesh,6.2 - Other places related to work,2014,0,0,2,2,2,0,0,0,0,0,0,2,0,2,0,2,0,4,2,0,0,6,0,2,0,0,0,0,2,2,4
Uttar Pradesh,6.3 - In Public Transport system,2014,1,0,3,3,3,0,0,0,0,0,0,3,1,4,0,4,0,3,4,0,0,7,0,2,0,2,2,0,0,0,5
Uttar Pradesh,6.4 - in Other Places,2014,3,0,24,24,24,0,0,0,0,0,0,10,3,13,5,18,9,13,13,0,0,26,0,3,0,2,2,0,1,1,23
Uttar Pradesh,7 - Cruelty by Husband or his Relatives (Section 498A),2014,3282,877,9594,10471,10471,0,0,0,7,88,0,3807,2319,6126,3358,9579,4174,17750,6126,0,952,22924,94,3020,0,1376,1376,0,1644,1644,19810
Uttar Pradesh,8 - Importation of Girls from Foreign Country (Section 366B IPC),2014,0,0,0,0,0,0,0,0,0,0,0,0,0,0,0,0,0,0,0,0,0,0,0,0,0,0,0,0,0,0,0
Uttar Pradesh,9 - Abetment of Suicides of Women u/s 306 IPC,2014,5,2,237,239,239,0,0,0,0,8,0,148,5,153,25,186,58,80,153,0,0,233,0,16,0,9,9,0,7,7,217
Uttar Pradesh,"10 - Dowry Prohibition Act, 1961",2014,633,150,1983,2133,2133,0,0,1,0,32,0,1178,503,1681,568,2281,484,1265,1681,0,49,2897,4,217,0,108,108,0,109,109,2676
Uttar Pradesh,"11 - Indecent Representation of Women (Prohibition) Act, 1986",2014,0,0,1,1,1,0,0,0,0,0,0,1,0,1,0,1,0,3,1,0,0,4,0,0,0,0,0,0,0,0,4
Uttar Pradesh,12 - Commission of Sati Prevention Act 1987,2014,0,0,0,0,0,0,0,0,0,0,0,0,0,0,0,0,0,0,0,0,0,0,0,0,0,0,0,0,0,0,0
Uttar Pradesh,"13 - Protection of Women from Domestic Violence Act, 2005",2014,1,0,66,66,66,0,0,0,0,0,0,66,1,67,0,67,0,8,67,0,0,75,0,2,0,2,2,0,0,0,73
Uttar Pradesh,14 - Immoral Traffic (Prevention) Act (Women Cases only),2014,5,0,37,37,51,0,0,0,0,1,0,29,5,34,1,36,6,163,34,0,0,197,0,34,0,22,22,0,12,12,163
Uttar Pradesh,14.1 - Under ITP Section 5,2014,1,0,21,21,31,0,0,0,0,1,0,15,1,16,1,18,4,79,16,0,0,95,0,21,0,13,13,0,8,8,74
Uttar Pradesh,14.2 - Under ITP Section 6,2014,4,0,10,10,14,0,0,0,0,0,0,9,4,13,0,13,1,53,13,0,0,66,0,7,0,4,4,0,3,3,59
Uttar Pradesh,14.3 - Under ITP Section 7,2014,0,0,0,0,0,0,0,0,0,0,0,0,0,0,0,0,0,3,0,0,0,3,0,3,0,3,3,0,0,0,0
Uttar Pradesh,14.4 - Under ITP Section 8,2014,0,0,0,0,0,0,0,0,0,0,0,0,0,0,0,0,0,1,0,0,0,1,0,1,0,1,1,0,0,0,0
Uttar Pradesh,14.5 - Other Sections under ITP Act,2014,0,0,6,6,6,0,0,0,0,0,0,5,0,5,0,5,1,27,5,0,0,32,0,2,0,1,1,0,1,1,30
Uttar Pradesh,15 - Total Crimes against Women,2014,8009,2088,36379,38467,38498,0,0,1,24,1865,0,20025,6359,26384,9150,37423,9052,58514,26384,0,1122,83776,365,10454,11,5268,5279,11,5164,5175,72957
Uttarakhand,1 - Rape (Section 376 IPC),2014,27,11,259,270,270,0,0,0,30,2,0,187,8,195,25,252,45,233,195,1,0,427,0,134,12,42,54,7,73,80,293
Uttarakhand,1.1 - Custodial Rape,2014,0,0,0,0,0,0,0,0,0,0,0,0,0,0,0,0,0,0,0,0,0,0,0,0,0,0,0,0,0,0,0
Uttarakhand,1.1.1 - Custodial_Gang Rape,2014,0,0,0,0,0,0,0,0,0,0,0,0,0,0,0,0,0,0,0,0,0,0,0,0,0,0,0,0,0,0,0
Uttarakhand,1.1.2 - Custodial_Other Rape,2014,0,0,0,0,0,0,0,0,0,0,0,0,0,0,0,0,0,0,0,0,0,0,0,0,0,0,0,0,0,0,0
Uttarakhand,1.2 - Rape other than Custodial,2014,27,11,259,270,270,0,0,0,30,2,0,187,8,195,25,252,45,233,195,1,0,427,0,134,12,42,54,7,73,80,293
Uttarakhand,1.2.1 - Rape_Gang Rape,2014,0,0,1,1,1,0,0,0,0,0,0,1,0,1,0,1,0,0,1,0,0,1,0,0,0,0,0,0,0,0,1
Uttarakhand,1.2.2 - Rape_Others,2014,27,11,258,269,269,0,0,0,30,2,0,186,8,194,25,251,45,233,194,1,0,426,0,134,12,42,54,7,73,80,292
Uttarakhand,2 - Attempt to commit Rape (Section 376 & 511 IPC),2014,0,11,30,41,41,0,0,0,4,0,0,29,2,31,2,37,4,0,31,0,0,31,0,6,0,3,3,1,2,3,25
Uttarakhand,"3 - Kidnapping & Abduction of Women (Section 363,364,364A, 366-369 IPC)",2014,52,1,274,275,394,0,0,0,33,22,0,108,3,111,130,296,31,408,111,1,0,518,1,79,1,40,41,2,36,38,438
Uttarakhand,3.1 - Kidnaping & Abduction Section 363 IPC,2014,2,0,62,62,136,0,0,0,10,1,0,51,2,53,0,64,0,175,53,0,0,228,1,47,0,28,28,0,19,19,180
Uttarakhand,3.2 - Kidnaping & Abduction in order to Murder Section 364 IPC,2014,0,0,1,1,1,0,0,0,0,0,0,1,0,1,0,1,0,0,1,0,0,1,0,0,0,0,0,0,0,0,1
Uttarakhand,3.3 - Kidnapping for Ransom Section 364A,2014,0,0,0,0,0,0,0,0,0,0,0,0,0,0,0,0,0,0,0,0,0,0,0,0,0,0,0,0,0,0,0
Uttarakhand,3.4 - Kidnapping & Abduction of Women to compel her for marriage,2014,27,0,10,10,10,0,0,0,7,20,0,7,0,7,2,36,1,69,7,0,0,76,0,7,0,0,0,0,7,7,69
Uttarakhand,3.5 - Kidnapping & Abduction of Women-Other,2014,23,1,201,202,247,0,0,0,16,1,0,49,1,50,128,195,30,164,50,1,0,213,0,25,1,12,13,2,10,12,188
Uttarakhand,4 - Dowry Deaths (Section 304-B IPC),2014,13,0,38,38,38,0,0,0,1,2,0,31,4,35,8,46,5,148,35,0,0,183,0,36,0,15,15,5,16,21,147
Uttarakhand,5 - Assault on Women with intent to outrage her Modesty_Total (Section 354 IPC),2014,27,16,327,343,347,0,0,0,25,7,0,268,1,269,36,337,33,499,269,2,0,766,3,164,7,89,96,6,62,68,599
Uttarakhand,5.1 - Sexual Harassment,2014,0,0,22,22,23,0,0,0,0,2,0,16,0,16,1,19,3,4,16,0,0,20,0,3,1,2,3,0,0,0,17
Uttarakhand,5.2 - Assault on women with intent to Disrobe,2014,1,0,24,24,25,0,0,0,0,1,0,20,0,20,3,24,1,1,20,0,0,21,0,1,0,0,0,1,0,1,20
Uttarakhand,5.3 - Voyeurism,2014,0,0,1,1,1,0,0,0,0,0,0,1,0,1,0,1,0,0,1,0,0,1,0,0,0,0,0,0,0,0,1
Uttarakhand,5.4 - Stalking,2014,0,0,7,7,7,0,0,0,0,1,0,6,0,6,0,7,0,0,6,0,0,6,0,3,1,0,1,2,0,2,3
Uttarakhand,5.5 - Others,2014,26,16,273,289,291,0,0,0,25,3,0,225,1,226,32,286,29,494,226,2,0,718,3,157,5,87,92,3,62,65,558
Uttarakhand,6 - Insult to the Modesty of Women_Total (Section 509 IPC),2014,5,0,4,4,4,0,0,0,0,3,0,4,2,6,0,9,0,461,6,0,0,467,0,51,0,26,26,0,25,25,416
Uttarakhand,6.1 - At Office premises,2014,0,0,0,0,0,0,0,0,0,0,0,0,0,0,0,0,0,0,0,0,0,0,0,0,0,0,0,0,0,0,0
Uttarakhand,6.2 - Other places related to work,2014,0,0,0,0,0,0,0,0,0,0,0,0,0,0,0,0,0,0,0,0,0,0,0,0,0,0,0,0,0,0,0
Uttarakhand,6.3 - In Public Transport system,2014,0,0,0,0,0,0,0,0,0,0,0,0,0,0,0,0,0,0,0,0,0,0,0,0,0,0,0,0,0,0,0
Uttarakhand,6.4 - in Other Places,2014,5,0,4,4,4,0,0,0,0,3,0,4,2,6,0,9,0,461,6,0,0,467,0,51,0,26,26,0,25,25,416
Uttarakhand,7 - Cruelty by Husband or his Relatives (Section 498A),2014,123,30,271,301,301,0,0,0,5,16,0,217,10,227,94,342,82,1411,227,0,0,1638,191,180,4,44,48,1,131,132,1267
Uttarakhand,8 - Importation of Girls from Foreign Country (Section 366B IPC),2014,0,0,0,0,0,0,0,0,0,0,0,0,0,0,0,0,0,0,0,0,0,0,0,0,0,0,0,0,0,0,0
Uttarakhand,9 - Abetment of Suicides of Women u/s 306 IPC,2014,0,0,0,0,0,0,0,0,0,0,0,0,0,0,0,0,0,0,0,0,0,0,0,0,0,0,0,0,0,0,0
Uttarakhand,"10 - Dowry Prohibition Act, 1961",2014,0,70,34,104,104,0,0,0,15,0,0,86,0,86,1,102,2,6,86,0,0,92,0,0,0,0,0,0,0,0,92
Uttarakhand,"11 - Indecent Representation of Women (Prohibition) Act, 1986",2014,0,0,0,0,0,0,0,0,0,0,0,0,0,0,0,0,0,0,0,0,0,0,0,0,0,0,0,0,0,0,0
Uttarakhand,12 - Commission of Sati Prevention Act 1987,2014,0,0,0,0,0,0,0,0,0,0,0,0,0,0,0,0,0,0,0,0,0,0,0,0,0,0,0,0,0,0,0
Uttarakhand,"13 - Protection of Women from Domestic Violence Act, 2005",2014,0,0,0,0,0,0,0,0,0,0,0,0,0,0,0,0,0,0,0,0,0,0,0,0,0,0,0,0,0,0,0
Uttarakhand,14 - Immoral Traffic (Prevention) Act (Women Cases only),2014,0,0,19,19,24,0,0,0,0,0,0,19,0,19,0,19,0,5,19,0,0,24,0,0,0,0,0,0,0,0,24
Uttarakhand,14.1 - Under ITP Section 5,2014,0,0,12,12,16,0,0,0,0,0,0,12,0,12,0,12,0,0,12,0,0,12,0,0,0,0,0,0,0,0,12
Uttarakhand,14.2 - Under ITP Section 6,2014,0,0,0,0,0,0,0,0,0,0,0,0,0,0,0,0,0,0,0,0,0,0,0,0,0,0,0,0,0,0,0
Uttarakhand,14.3 - Under ITP Section 7,2014,0,0,0,0,0,0,0,0,0,0,0,0,0,0,0,0,0,0,0,0,0,0,0,0,0,0,0,0,0,0,0
Uttarakhand,14.4 - Under ITP Section 8,2014,0,0,0,0,0,0,0,0,0,0,0,0,0,0,0,0,0,0,0,0,0,0,0,0,0,0,0,0,0,0,0
Uttarakhand,14.5 - Other Sections under ITP Act,2014,0,0,7,7,8,0,0,0,0,0,0,7,0,7,0,7,0,5,7,0,0,12,0,0,0,0,0,0,0,0,12
Uttarakhand,15 - Total Crimes against Women,2014,247,139,1256,1395,1523,0,0,0,113,52,0,949,30,979,296,1440,202,3171,979,4,0,4146,195,650,24,259,283,22,345,367,3301
West Bengal,1 - Rape (Section 376 IPC),2014,1411,323,1143,1466,1466,0,0,9,0,0,4,742,711,1453,91,1548,1320,15554,1453,0,0,17007,1,1046,12,96,108,67,871,938,15960
West Bengal,1.1 - Custodial Rape,2014,0,0,0,0,0,0,0,0,0,0,0,0,0,0,0,0,0,0,0,0,0,0,0,0,0,0,0,0,0,0,0
West Bengal,1.1.1 - Custodial_Gang Rape,2014,0,0,0,0,0,0,0,0,0,0,0,0,0,0,0,0,0,0,0,0,0,0,0,0,0,0,0,0,0,0,0
West Bengal,1.1.2 - Custodial_Other Rape,2014,0,0,0,0,0,0,0,0,0,0,0,0,0,0,0,0,0,0,0,0,0,0,0,0,0,0,0,0,0,0,0
West Bengal,1.2 - Rape other than Custodial,2014,1411,323,1143,1466,1466,0,0,9,0,0,4,742,711,1453,91,1548,1320,15554,1453,0,0,17007,1,1046,12,96,108,67,871,938,15960
West Bengal,1.2.1 - Rape_Gang Rape,2014,29,20,158,178,178,0,0,2,0,0,0,90,29,119,6,125,80,70,119,0,0,189,0,19,1,8,9,1,9,10,170
West Bengal,1.2.2 - Rape_Others,2014,1382,303,985,1288,1288,0,0,7,0,0,4,652,682,1334,85,1423,1240,15484,1334,0,0,16818,1,1027,11,88,99,66,862,928,15790
West Bengal,2 - Attempt to commit Rape (Section 376 & 511 IPC),2014,255,412,1244,1656,1656,0,0,0,0,0,0,1007,255,1262,44,1306,605,1350,1262,0,0,2612,0,542,0,12,12,48,482,530,2070
West Bengal,"3 - Kidnapping & Abduction of Women (Section 363,364,364A, 366-369 IPC)",2014,4295,537,4439,4976,5062,0,0,26,0,0,39,1796,1522,3318,529,3886,5359,15377,3318,0,0,18695,6,969,0,3,3,89,877,966,17720
West Bengal,3.1 - Kidnaping & Abduction Section 363 IPC,2014,1274,108,1496,1604,1646,0,0,11,0,0,32,576,557,1133,108,1273,1594,5483,1133,0,0,6616,2,224,0,0,0,36,188,224,6390
West Bengal,3.2 - Kidnaping & Abduction in order to Murder Section 364 IPC,2014,3,2,9,11,12,0,0,0,0,0,0,6,1,7,1,8,6,42,7,0,0,49,0,4,0,0,0,0,4,4,45
West Bengal,3.3 - Kidnapping for Ransom Section 364A,2014,58,0,36,36,36,0,0,0,0,0,0,18,15,33,0,33,61,50,33,0,0,83,0,6,0,1,1,1,4,5,77
West Bengal,3.4 - Kidnapping & Abduction of Women to compel her for marriage,2014,986,239,959,1198,1201,0,0,3,0,0,0,466,394,860,114,974,1207,3905,860,0,0,4765,0,602,0,0,0,21,581,602,4163
West Bengal,3.5 - Kidnapping & Abduction of Women-Other,2014,1974,188,1939,2127,2167,0,0,12,0,0,7,730,555,1285,306,1598,2491,5897,1285,0,0,7182,4,133,0,2,2,31,100,131,7045
West Bengal,4 - Dowry Deaths (Section 304-B IPC),2014,579,19,482,501,501,0,0,0,0,0,0,247,352,599,11,610,470,2714,599,0,0,3313,0,249,4,22,26,23,200,223,3064
West Bengal,5 - Assault on Women with intent to outrage her Modesty_Total (Section 354 IPC),2014,2607,603,5067,5670,5702,0,0,1,0,0,14,3915,1519,5434,251,5699,2577,19258,5434,0,0,24692,20,959,20,69,89,162,708,870,23713
West Bengal,5.1 - Sexual Harassment,2014,330,87,958,1045,1047,0,0,1,0,0,3,724,171,895,39,937,437,2571,895,0,0,3466,5,69,0,7,7,9,53,62,3392
West Bengal,5.2 - Assault on women with intent to Disrobe,2014,43,98,589,687,687,0,0,0,0,0,10,456,43,499,36,545,185,817,499,0,0,1316,8,67,0,3,3,32,32,64,1241
West Bengal,5.3 - Voyeurism,2014,29,10,47,57,57,0,0,0,0,0,0,28,9,37,5,42,44,23,37,0,0,60,0,4,0,1,1,2,1,3,56
West Bengal,5.4 - Stalking,2014,31,6,253,259,259,0,0,0,0,0,0,189,13,202,14,216,74,61,202,0,0,263,2,37,3,11,14,13,10,23,224
West Bengal,5.5 - Others,2014,2174,402,3220,3622,3652,0,0,0,0,0,1,2518,1283,3801,157,3959,1837,15786,3801,0,0,19587,5,782,17,47,64,106,612,718,18800
West Bengal,6 - Insult to the Modesty of Women_Total (Section 509 IPC),2014,223,9,534,543,544,0,0,1,0,0,1,308,100,408,85,494,271,352,408,0,0,760,5,208,102,26,128,52,28,80,547
West Bengal,6.1 - At Office premises,2014,0,0,4,4,4,0,0,0,0,0,0,1,0,1,0,1,3,7,1,0,0,8,0,0,0,0,0,0,0,0,8
West Bengal,6.2 - Other places related to work,2014,0,0,5,5,5,0,0,0,0,0,0,3,0,3,0,3,2,0,3,0,0,3,0,0,0,0,0,0,0,0,3
West Bengal,6.3 - In Public Transport system,2014,0,0,8,8,8,0,0,0,0,0,0,3,0,3,1,4,4,0,3,0,0,3,0,0,0,0,0,0,0,0,3
West Bengal,6.4 - in Other Places,2014,223,9,517,526,527,0,0,1,0,0,1,301,100,401,84,486,262,345,401,0,0,746,5,208,102,26,128,52,28,80,533
West Bengal,7 - Cruelty by Husband or his Relatives (Section 498A),2014,8605,5845,17433,23278,23278,0,0,109,0,0,2,14788,7675,22463,358,22823,8951,124137,22463,0,0,146600,109,4603,7,38,45,664,3894,4558,141888
West Bengal,8 - Importation of Girls from Foreign Country (Section 366B IPC),2014,4,0,4,4,4,0,0,0,0,0,0,2,2,4,1,5,3,19,4,0,0,23,0,5,0,1,1,0,4,4,18
West Bengal,9 - Abetment of Suicides of Women u/s 306 IPC,2014,28,5,114,119,120,0,0,0,0,0,0,59,18,77,2,79,68,27,77,0,0,104,0,7,0,0,0,0,7,7,97
West Bengal,"10 - Dowry Prohibition Act, 1961",2014,179,0,1,1,1,0,0,0,0,0,0,1,143,144,0,144,36,326,144,0,0,470,0,36,0,0,0,0,36,36,434
West Bengal,"11 - Indecent Representation of Women (Prohibition) Act, 1986",2014,10,0,4,4,4,0,0,0,0,0,0,2,2,4,0,4,10,22,4,0,0,26,0,0,0,0,0,0,0,0,26
West Bengal,12 - Commission of Sati Prevention Act 1987,2014,0,0,0,0,0,0,0,0,0,0,0,0,0,0,0,0,0,0,0,0,0,0,0,0,0,0,0,0,0,0,0
West Bengal,"13 - Protection of Women from Domestic Violence Act, 2005",2014,0,1,0,1,1,0,0,0,0,0,0,1,0,1,0,1,0,0,1,0,0,1,0,0,0,0,0,0,0,0,1
West Bengal,14 - Immoral Traffic (Prevention) Act (Women Cases only),2014,114,0,80,80,125,0,0,0,0,0,1,45,75,120,5,126,68,148,120,0,0,268,0,36,3,7,10,4,22,26,232
West Bengal,14.1 - Under ITP Section 5,2014,17,0,20,20,31,0,0,0,0,0,0,9,12,21,0,21,16,18,21,0,0,39,0,6,0,0,0,0,6,6,33
West Bengal,14.2 - Under ITP Section 6,2014,1,0,3,3,3,0,0,0,0,0,0,1,1,2,0,2,2,2,2,0,0,4,0,0,0,0,0,0,0,0,4
West Bengal,14.3 - Under ITP Section 7,2014,2,0,5,5,5,0,0,0,0,0,0,2,1,3,1,4,3,2,3,0,0,5,0,0,0,0,0,0,0,0,5
West Bengal,14.4 - Under ITP Section 8,2014,0,0,1,1,1,0,0,0,0,0,0,1,0,1,0,1,0,0,1,0,0,1,0,0,0,0,0,0,0,0,1
West Bengal,14.5 - Other Sections under ITP Act,2014,94,0,51,51,85,0,0,0,0,0,1,32,61,93,4,98,47,126,93,0,0,219,0,30,3,7,10,4,16,20,189
West Bengal,15 - Total Crimes against Women,2014,18310,7754,30545,38299,38464,0,0,146,0,0,61,22913,12374,35287,1377,36725,19738,179284,35287,0,0,214571,141,8660,148,274,422,1109,7129,8238,205770
A & N Islands,1 - Rape (Section 376 IPC),2014,4,0,32,32,32,0,0,0,0,0,0,26,4,30,1,31,5,107,30,0,0,137,0,23,0,3,3,1,19,20,114
A & N Islands,1.1 - Custodial Rape,2014,0,0,0,0,0,0,0,0,0,0,0,0,0,0,0,0,0,0,0,0,0,0,0,0,0,0,0,0,0,0,0
A & N Islands,1.1.1 - Custodial_Gang Rape,2014,0,0,0,0,0,0,0,0,0,0,0,0,0,0,0,0,0,0,0,0,0,0,0,0,0,0,0,0,0,0,0
A & N Islands,1.1.2 - Custodial_Other Rape,2014,0,0,0,0,0,0,0,0,0,0,0,0,0,0,0,0,0,0,0,0,0,0,0,0,0,0,0,0,0,0,0
A & N Islands,1.2 - Rape other than Custodial,2014,4,0,32,32,32,0,0,0,0,0,0,26,4,30,1,31,5,107,30,0,0,137,0,23,0,3,3,1,19,20,114
A & N Islands,1.2.1 - Rape_Gang Rape,2014,0,0,1,1,1,0,0,0,0,0,0,1,0,1,0,1,0,0,1,0,0,1,0,0,0,0,0,0,0,0,1
A & N Islands,1.2.2 - Rape_Others,2014,4,0,31,31,31,0,0,0,0,0,0,25,4,29,1,30,5,107,29,0,0,136,0,23,0,3,3,1,19,20,113
A & N Islands,2 - Attempt to commit Rape (Section 376 & 511 IPC),2014,0,0,0,0,0,0,0,0,0,0,0,0,0,0,0,0,0,0,0,0,0,0,0,0,0,0,0,0,0,0,0
A & N Islands,"3 - Kidnapping & Abduction of Women (Section 363,364,364A, 366-369 IPC)",2014,3,0,17,17,27,0,0,0,0,5,0,7,1,8,7,20,0,53,8,0,0,61,0,14,0,0,0,0,14,14,47
A & N Islands,3.1 - Kidnaping & Abduction Section 363 IPC,2014,1,0,11,11,13,0,0,0,0,4,0,4,1,5,3,12,0,40,5,0,0,45,0,13,0,0,0,0,13,13,32
A & N Islands,3.2 - Kidnaping & Abduction in order to Murder Section 364 IPC,2014,0,0,0,0,0,0,0,0,0,0,0,0,0,0,0,0,0,0,0,0,0,0,0,0,0,0,0,0,0,0,0
A & N Islands,3.3 - Kidnapping for Ransom Section 364A,2014,0,0,0,0,0,0,0,0,0,0,0,0,0,0,0,0,0,0,0,0,0,0,0,0,0,0,0,0,0,0,0
A & N Islands,3.4 - Kidnapping & Abduction of Women to compel her for marriage,2014,0,0,0,0,0,0,0,0,0,0,0,0,0,0,0,0,0,0,0,0,0,0,0,0,0,0,0,0,0,0,0
A & N Islands,3.5 - Kidnapping & Abduction of Women-Other,2014,2,0,6,6,14,0,0,0,0,1,0,3,0,3,4,8,0,13,3,0,0,16,0,1,0,0,0,0,1,1,15
A & N Islands,4 - Dowry Deaths (Section 304-B IPC),2014,1,0,3,3,3,0,0,0,0,0,0,1,1,2,0,2,2,7,2,0,0,9,0,0,0,0,0,0,0,0,9
A & N Islands,5 - Assault on Women with intent to outrage her Modesty_Total (Section 354 IPC),2014,10,0,41,41,41,0,0,0,0,0,0,32,10,42,0,42,9,245,42,0,0,287,0,45,1,8,9,0,36,36,242
A & N Islands,5.1 - Sexual Harassment,2014,5,0,18,18,18,0,0,0,0,0,0,15,5,20,0,20,3,55,20,0,0,75,0,16,1,0,1,0,15,15,59
A & N Islands,5.2 - Assault on women with intent to Disrobe,2014,0,0,1,1,1,0,0,0,0,0,0,0,0,0,0,0,1,3,0,0,0,3,0,1,0,1,1,0,0,0,2
A & N Islands,5.3 - Voyeurism,2014,0,0,1,1,1,0,0,0,0,0,0,0,0,0,0,0,1,0,0,0,0,0,0,0,0,0,0,0,0,0,0
A & N Islands,5.4 - Stalking,2014,0,0,4,4,4,0,0,0,0,0,0,1,0,1,0,1,3,0,1,0,0,1,0,0,0,0,0,0,0,0,1
A & N Islands,5.5 - Others,2014,5,0,17,17,17,0,0,0,0,0,0,16,5,21,0,21,1,187,21,0,0,208,0,28,0,7,7,0,21,21,180
A & N Islands,6 - Insult to the Modesty of Women_Total (Section 509 IPC),2014,1,0,5,5,5,0,0,0,0,0,1,4,1,5,0,6,0,44,5,0,0,49,0,25,0,0,0,1,24,25,24
A & N Islands,6.1 - At Office premises,2014,0,0,0,0,0,0,0,0,0,0,0,0,0,0,0,0,0,0,0,0,0,0,0,0,0,0,0,0,0,0,0
A & N Islands,6.2 - Other places related to work,2014,0,0,0,0,0,0,0,0,0,0,0,0,0,0,0,0,0,0,0,0,0,0,0,0,0,0,0,0,0,0,0
A & N Islands,6.3 - In Public Transport system,2014,0,0,0,0,0,0,0,0,0,0,0,0,0,0,0,0,0,0,0,0,0,0,0,0,0,0,0,0,0,0,0
A & N Islands,6.4 - in Other Places,2014,1,0,5,5,5,0,0,0,0,0,1,4,1,5,0,6,0,44,5,0,0,49,0,25,0,0,0,1,24,25,24
A & N Islands,7 - Cruelty by Husband or his Relatives (Section 498A),2014,3,3,11,14,14,0,0,0,0,0,0,5,3,8,4,12,5,68,8,0,0,76,0,19,0,0,0,2,17,19,57
A & N Islands,8 - Importation of Girls from Foreign Country (Section 366B IPC),2014,0,0,0,0,0,0,0,0,0,0,0,0,0,0,0,0,0,0,0,0,0,0,0,0,0,0,0,0,0,0,0
A & N Islands,9 - Abetment of Suicides of Women u/s 306 IPC,2014,0,0,2,2,2,0,0,0,0,0,0,2,0,2,0,2,0,8,2,0,0,10,0,0,0,0,0,0,0,0,10
A & N Islands,"10 - Dowry Prohibition Act, 1961",2014,0,0,0,0,0,0,0,0,0,0,0,0,0,0,0,0,0,1,0,0,0,1,0,0,0,0,0,0,0,0,1
A & N Islands,"11 - Indecent Representation of Women (Prohibition) Act, 1986",2014,0,0,0,0,0,0,0,0,0,0,0,0,0,0,0,0,0,0,0,0,0,0,0,0,0,0,0,0,0,0,0
A & N Islands,12 - Commission of Sati Prevention Act 1987,2014,0,0,0,0,0,0,0,0,0,0,0,0,0,0,0,0,0,0,0,0,0,0,0,0,0,0,0,0,0,0,0
A & N Islands,"13 - Protection of Women from Domestic Violence Act, 2005",2014,0,0,0,0,0,0,0,0,0,0,0,0,0,0,0,0,0,0,0,0,0,0,0,0,0,0,0,0,0,0,0
A & N Islands,14 - Immoral Traffic (Prevention) Act (Women Cases only),2014,0,0,1,1,2,0,0,0,0,0,0,0,0,0,0,0,1,0,0,0,0,0,0,0,0,0,0,0,0,0,0
A & N Islands,14.1 - Under ITP Section 5,2014,0,0,1,1,2,0,0,0,0,0,0,0,0,0,0,0,1,0,0,0,0,0,0,0,0,0,0,0,0,0,0
A & N Islands,14.2 - Under ITP Section 6,2014,0,0,0,0,0,0,0,0,0,0,0,0,0,0,0,0,0,0,0,0,0,0,0,0,0,0,0,0,0,0,0
A & N Islands,14.3 - Under ITP Section 7,2014,0,0,0,0,0,0,0,0,0,0,0,0,0,0,0,0,0,0,0,0,0,0,0,0,0,0,0,0,0,0,0
A & N Islands,14.4 - Under ITP Section 8,2014,0,0,0,0,0,0,0,0,0,0,0,0,0,0,0,0,0,0,0,0,0,0,0,0,0,0,0,0,0,0,0
A & N Islands,14.5 - Other Sections under ITP Act,2014,0,0,0,0,0,0,0,0,0,0,0,0,0,0,0,0,0,0,0,0,0,0,0,0,0,0,0,0,0,0,0
A & N Islands,15 - Total Crimes against Women,2014,22,3,112,115,126,0,0,0,0,5,1,77,20,97,12,115,22,533,97,0,0,630,0,126,1,11,12,4,110,114,504
Chandigarh,1 - Rape (Section 376 IPC),2014,19,1,58,59,59,0,0,0,0,1,0,21,26,47,1,49,29,33,47,0,0,80,0,37,3,9,12,6,19,25,43
Chandigarh,1.1 - Custodial Rape,2014,0,0,0,0,0,0,0,0,0,0,0,0,0,0,0,0,0,0,0,0,0,0,0,0,0,0,0,0,0,0,0
Chandigarh,1.1.1 - Custodial_Gang Rape,2014,0,0,0,0,0,0,0,0,0,0,0,0,0,0,0,0,0,0,0,0,0,0,0,0,0,0,0,0,0,0,0
Chandigarh,1.1.2 - Custodial_Other Rape,2014,0,0,0,0,0,0,0,0,0,0,0,0,0,0,0,0,0,0,0,0,0,0,0,0,0,0,0,0,0,0,0
Chandigarh,1.2 - Rape other than Custodial,2014,19,1,58,59,59,0,0,0,0,1,0,21,26,47,1,49,29,33,47,0,0,80,0,37,3,9,12,6,19,25,43
Chandigarh,1.2.1 - Rape_Gang Rape,2014,0,0,0,0,0,0,0,0,0,0,0,0,0,0,0,0,0,0,0,0,0,0,0,0,0,0,0,0,0,0,0
Chandigarh,1.2.2 - Rape_Others,2014,19,1,58,59,59,0,0,0,0,1,0,21,26,47,1,49,29,33,47,0,0,80,0,37,3,9,12,6,19,25,43
Chandigarh,2 - Attempt to commit Rape (Section 376 & 511 IPC),2014,5,0,6,6,6,0,0,0,0,2,0,3,1,4,1,7,4,6,4,0,0,10,0,3,0,2,2,1,0,1,7
Chandigarh,"3 - Kidnapping & Abduction of Women (Section 363,364,364A, 366-369 IPC)",2014,96,0,133,133,138,0,0,0,0,87,0,19,34,53,12,152,77,76,53,0,0,129,0,44,0,7,7,10,27,37,85
Chandigarh,3.1 - Kidnaping & Abduction Section 363 IPC,2014,15,0,84,84,86,0,0,0,0,48,0,3,7,10,4,62,37,36,10,0,0,46,0,30,0,4,4,2,24,26,16
Chandigarh,3.2 - Kidnaping & Abduction in order to Murder Section 364 IPC,2014,0,0,0,0,0,0,0,0,0,0,0,0,0,0,0,0,0,0,0,0,0,0,0,0,0,0,0,0,0,0,0
Chandigarh,3.3 - Kidnapping for Ransom Section 364A,2014,0,0,0,0,0,0,0,0,0,0,0,0,0,0,0,0,0,0,0,0,0,0,0,0,0,0,0,0,0,0,0
Chandigarh,3.4 - Kidnapping & Abduction of Women to compel her for marriage,2014,71,0,43,43,43,0,0,0,0,39,0,10,23,33,6,78,36,36,33,0,0,69,0,12,0,3,3,8,1,9,57
Chandigarh,3.5 - Kidnapping & Abduction of Women-Other,2014,10,0,6,6,9,0,0,0,0,0,0,6,4,10,2,12,4,4,10,0,0,14,0,2,0,0,0,0,2,2,12
Chandigarh,4 - Dowry Deaths (Section 304-B IPC),2014,1,0,2,2,2,0,0,0,0,0,0,2,1,3,0,3,0,2,3,0,0,5,0,3,0,2,2,0,1,1,2
Chandigarh,5 - Assault on Women with intent to outrage her Modesty_Total (Section 354 IPC),2014,53,1,86,87,87,0,0,0,0,15,0,43,42,85,6,106,34,129,85,0,0,214,0,74,6,19,25,9,40,49,140
Chandigarh,5.1 - Sexual Harassment,2014,4,1,30,31,31,0,0,0,0,1,0,14,9,23,0,24,11,27,23,0,0,50,0,24,3,6,9,4,11,15,26
Chandigarh,5.2 - Assault on women with intent to Disrobe,2014,0,0,3,3,3,0,0,0,0,0,0,2,0,2,0,2,1,4,2,0,0,6,0,4,0,2,2,0,2,2,2
Chandigarh,5.3 - Voyeurism,2014,0,0,2,2,2,0,0,0,0,0,0,2,0,2,0,2,0,0,2,0,0,2,0,0,0,0,0,0,0,0,2
Chandigarh,5.4 - Stalking,2014,2,0,10,10,10,0,0,0,0,0,0,7,1,8,0,8,4,8,8,0,0,16,0,7,1,1,2,1,4,5,9
Chandigarh,5.5 - Others,2014,47,0,41,41,41,0,0,0,0,14,0,18,32,50,6,70,18,90,50,0,0,140,0,39,2,10,12,4,23,27,101
Chandigarh,6 - Insult to the Modesty of Women_Total (Section 509 IPC),2014,12,0,2,2,2,0,0,0,0,2,0,1,7,8,2,12,2,41,8,0,0,49,0,18,0,6,6,0,12,12,31
Chandigarh,6.1 - At Office premises,2014,0,0,0,0,0,0,0,0,0,0,0,0,0,0,0,0,0,1,0,0,0,1,0,0,0,0,0,0,0,0,1
Chandigarh,6.2 - Other places related to work,2014,4,0,0,0,0,0,0,0,0,0,0,0,3,3,0,3,1,5,3,0,0,8,0,4,0,1,1,0,3,3,4
Chandigarh,6.3 - In Public Transport system,2014,0,0,0,0,0,0,0,0,0,0,0,0,0,0,0,0,0,0,0,0,0,0,0,0,0,0,0,0,0,0,0
Chandigarh,6.4 - in Other Places,2014,8,0,2,2,2,0,0,0,0,2,0,1,4,5,2,9,1,35,5,0,0,40,0,14,0,5,5,0,9,9,26
Chandigarh,7 - Cruelty by Husband or his Relatives (Section 498A),2014,102,3,138,141,141,0,0,0,0,26,0,29,33,62,2,90,153,237,62,0,0,299,0,58,0,11,11,0,47,47,241
Chandigarh,8 - Importation of Girls from Foreign Country (Section 366B IPC),2014,0,0,0,0,0,0,0,0,0,0,0,0,0,0,0,0,0,0,0,0,0,0,0,0,0,0,0,0,0,0,0
Chandigarh,9 - Abetment of Suicides of Women u/s 306 IPC,2014,0,0,0,0,0,0,0,0,0,0,0,0,0,0,0,0,0,0,0,0,0,0,0,0,0,0,0,0,0,0,0
Chandigarh,"10 - Dowry Prohibition Act, 1961",2014,0,0,2,2,2,0,0,0,0,0,0,0,0,0,0,0,2,0,0,0,0,0,0,0,0,0,0,0,0,0,0
Chandigarh,"11 - Indecent Representation of Women (Prohibition) Act, 1986",2014,2,0,0,0,0,0,0,0,0,1,0,0,0,0,0,1,1,0,0,0,0,0,0,0,0,0,0,0,0,0,0
Chandigarh,12 - Commission of Sati Prevention Act 1987,2014,0,0,0,0,0,0,0,0,0,0,0,0,0,0,0,0,0,0,0,0,0,0,0,0,0,0,0,0,0,0,0
Chandigarh,"13 - Protection of Women from Domestic Violence Act, 2005",2014,0,0,0,0,0,0,0,0,0,0,0,0,0,0,0,0,0,0,0,0,0,0,0,0,0,0,0,0,0,0,0
Chandigarh,14 - Immoral Traffic (Prevention) Act (Women Cases only),2014,0,0,0,0,0,0,0,0,0,0,0,0,0,0,0,0,0,0,0,0,0,0,0,0,0,0,0,0,0,0,0
Chandigarh,14.1 - Under ITP Section 5,2014,0,0,0,0,0,0,0,0,0,0,0,0,0,0,0,0,0,0,0,0,0,0,0,0,0,0,0,0,0,0,0
Chandigarh,14.2 - Under ITP Section 6,2014,0,0,0,0,0,0,0,0,0,0,0,0,0,0,0,0,0,0,0,0,0,0,0,0,0,0,0,0,0,0,0
Chandigarh,14.3 - Under ITP Section 7,2014,0,0,0,0,0,0,0,0,0,0,0,0,0,0,0,0,0,0,0,0,0,0,0,0,0,0,0,0,0,0,0
Chandigarh,14.4 - Under ITP Section 8,2014,0,0,0,0,0,0,0,0,0,0,0,0,0,0,0,0,0,0,0,0,0,0,0,0,0,0,0,0,0,0,0
Chandigarh,14.5 - Other Sections under ITP Act,2014,0,0,0,0,0,0,0,0,0,0,0,0,0,0,0,0,0,0,0,0,0,0,0,0,0,0,0,0,0,0,0
Chandigarh,15 - Total Crimes against Women,2014,290,5,427,432,437,0,0,0,0,134,0,118,144,262,24,420,302,524,262,0,0,786,0,237,9,56,65,26,146,172,549
D&N Haveli,1 - Rape (Section 376 IPC),2014,3,0,5,5,5,0,0,0,0,0,0,5,3,8,0,8,0,13,8,0,0,21,0,3,0,0,0,0,3,3,18
D&N Haveli,1.1 - Custodial Rape,2014,0,0,0,0,0,0,0,0,0,0,0,0,0,0,0,0,0,0,0,0,0,0,0,0,0,0,0,0,0,0,0
D&N Haveli,1.1.1 - Custodial_Gang Rape,2014,0,0,0,0,0,0,0,0,0,0,0,0,0,0,0,0,0,0,0,0,0,0,0,0,0,0,0,0,0,0,0
D&N Haveli,1.1.2 - Custodial_Other Rape,2014,0,0,0,0,0,0,0,0,0,0,0,0,0,0,0,0,0,0,0,0,0,0,0,0,0,0,0,0,0,0,0
D&N Haveli,1.2 - Rape other than Custodial,2014,3,0,5,5,5,0,0,0,0,0,0,5,3,8,0,8,0,13,8,0,0,21,0,3,0,0,0,0,3,3,18
D&N Haveli,1.2.1 - Rape_Gang Rape,2014,0,0,0,0,0,0,0,0,0,0,0,0,0,0,0,0,0,0,0,0,0,0,0,0,0,0,0,0,0,0,0
D&N Haveli,1.2.2 - Rape_Others,2014,3,0,5,5,5,0,0,0,0,0,0,5,3,8,0,8,0,13,8,0,0,21,0,3,0,0,0,0,3,3,18
D&N Haveli,2 - Attempt to commit Rape (Section 376 & 511 IPC),2014,0,0,0,0,0,0,0,0,0,0,0,0,0,0,0,0,0,0,0,0,0,0,0,0,0,0,0,0,0,0,0
D&N Haveli,"3 - Kidnapping & Abduction of Women (Section 363,364,364A, 366-369 IPC)",2014,5,0,7,7,7,0,0,0,0,2,0,3,0,3,1,6,6,31,3,0,0,34,0,1,0,0,0,0,1,1,33
D&N Haveli,3.1 - Kidnaping & Abduction Section 363 IPC,2014,5,0,7,7,7,0,0,0,0,2,0,3,0,3,1,6,6,31,3,0,0,34,0,1,0,0,0,0,1,1,33
D&N Haveli,3.2 - Kidnaping & Abduction in order to Murder Section 364 IPC,2014,0,0,0,0,0,0,0,0,0,0,0,0,0,0,0,0,0,0,0,0,0,0,0,0,0,0,0,0,0,0,0
D&N Haveli,3.3 - Kidnapping for Ransom Section 364A,2014,0,0,0,0,0,0,0,0,0,0,0,0,0,0,0,0,0,0,0,0,0,0,0,0,0,0,0,0,0,0,0
D&N Haveli,3.4 - Kidnapping & Abduction of Women to compel her for marriage,2014,0,0,0,0,0,0,0,0,0,0,0,0,0,0,0,0,0,0,0,0,0,0,0,0,0,0,0,0,0,0,0
D&N Haveli,3.5 - Kidnapping & Abduction of Women-Other,2014,0,0,0,0,0,0,0,0,0,0,0,0,0,0,0,0,0,0,0,0,0,0,0,0,0,0,0,0,0,0,0
D&N Haveli,4 - Dowry Deaths (Section 304-B IPC),2014,0,0,0,0,0,0,0,0,0,0,0,0,0,0,0,0,0,2,0,0,0,2,0,0,0,0,0,0,0,0,2
D&N Haveli,5 - Assault on Women with intent to outrage her Modesty_Total (Section 354 IPC),2014,1,0,2,2,2,0,0,0,0,0,0,2,0,2,0,2,1,24,2,0,0,26,0,0,0,0,0,0,0,0,26
D&N Haveli,5.1 - Sexual Harassment,2014,0,0,0,0,0,0,0,0,0,0,0,0,0,0,0,0,0,0,0,0,0,0,0,0,0,0,0,0,0,0,0
D&N Haveli,5.2 - Assault on women with intent to Disrobe,2014,0,0,0,0,0,0,0,0,0,0,0,0,0,0,0,0,0,0,0,0,0,0,0,0,0,0,0,0,0,0,0
D&N Haveli,5.3 - Voyeurism,2014,0,0,0,0,0,0,0,0,0,0,0,0,0,0,0,0,0,0,0,0,0,0,0,0,0,0,0,0,0,0,0
D&N Haveli,5.4 - Stalking,2014,0,0,0,0,0,0,0,0,0,0,0,0,0,0,0,0,0,0,0,0,0,0,0,0,0,0,0,0,0,0,0
D&N Haveli,5.5 - Others,2014,1,0,2,2,2,0,0,0,0,0,0,2,0,2,0,2,1,24,2,0,0,26,0,0,0,0,0,0,0,0,26
D&N Haveli,6 - Insult to the Modesty of Women_Total (Section 509 IPC),2014,0,0,1,1,1,0,0,0,0,0,0,1,0,1,0,1,0,3,1,0,0,4,0,0,0,0,0,0,0,0,4
D&N Haveli,6.1 - At Office premises,2014,0,0,0,0,0,0,0,0,0,0,0,0,0,0,0,0,0,0,0,0,0,0,0,0,0,0,0,0,0,0,0
D&N Haveli,6.2 - Other places related to work,2014,0,0,0,0,0,0,0,0,0,0,0,0,0,0,0,0,0,0,0,0,0,0,0,0,0,0,0,0,0,0,0
D&N Haveli,6.3 - In Public Transport system,2014,0,0,0,0,0,0,0,0,0,0,0,0,0,0,0,0,0,0,0,0,0,0,0,0,0,0,0,0,0,0,0
D&N Haveli,6.4 - in Other Places,2014,0,0,1,1,1,0,0,0,0,0,0,1,0,1,0,1,0,3,1,0,0,4,0,0,0,0,0,0,0,0,4
D&N Haveli,7 - Cruelty by Husband or his Relatives (Section 498A),2014,4,1,5,6,6,0,0,0,0,0,0,2,0,2,1,3,7,17,2,0,0,19,0,2,0,0,0,0,2,2,17
D&N Haveli,8 - Importation of Girls from Foreign Country (Section 366B IPC),2014,0,0,0,0,0,0,0,0,0,0,0,0,0,0,0,0,0,0,0,0,0,0,0,0,0,0,0,0,0,0,0
D&N Haveli,9 - Abetment of Suicides of Women u/s 306 IPC,2014,0,0,0,0,0,0,0,0,0,0,0,0,0,0,0,0,0,0,0,0,0,0,0,0,0,0,0,0,0,0,0
D&N Haveli,"10 - Dowry Prohibition Act, 1961",2014,0,0,0,0,0,0,0,0,0,0,0,0,0,0,0,0,0,1,0,0,0,1,0,0,0,0,0,0,0,0,1
D&N Haveli,"11 - Indecent Representation of Women (Prohibition) Act, 1986",2014,0,0,0,0,0,0,0,0,0,0,0,0,0,0,0,0,0,0,0,0,0,0,0,0,0,0,0,0,0,0,0
D&N Haveli,12 - Commission of Sati Prevention Act 1987,2014,0,0,0,0,0,0,0,0,0,0,0,0,0,0,0,0,0,0,0,0,0,0,0,0,0,0,0,0,0,0,0
D&N Haveli,"13 - Protection of Women from Domestic Violence Act, 2005",2014,0,0,0,0,0,0,0,0,0,0,0,0,0,0,0,0,0,0,0,0,0,0,0,0,0,0,0,0,0,0,0
D&N Haveli,14 - Immoral Traffic (Prevention) Act (Women Cases only),2014,0,0,0,0,0,0,0,0,0,0,0,0,0,0,0,0,0,0,0,0,0,0,0,0,0,0,0,0,0,0,0
D&N Haveli,14.1 - Under ITP Section 5,2014,0,0,0,0,0,0,0,0,0,0,0,0,0,0,0,0,0,0,0,0,0,0,0,0,0,0,0,0,0,0,0
D&N Haveli,14.2 - Under ITP Section 6,2014,0,0,0,0,0,0,0,0,0,0,0,0,0,0,0,0,0,0,0,0,0,0,0,0,0,0,0,0,0,0,0
D&N Haveli,14.3 - Under ITP Section 7,2014,0,0,0,0,0,0,0,0,0,0,0,0,0,0,0,0,0,0,0,0,0,0,0,0,0,0,0,0,0,0,0
D&N Haveli,14.4 - Under ITP Section 8,2014,0,0,0,0,0,0,0,0,0,0,0,0,0,0,0,0,0,0,0,0,0,0,0,0,0,0,0,0,0,0,0
D&N Haveli,14.5 - Other Sections under ITP Act,2014,0,0,0,0,0,0,0,0,0,0,0,0,0,0,0,0,0,0,0,0,0,0,0,0,0,0,0,0,0,0,0
D&N Haveli,15 - Total Crimes against Women,2014,13,1,20,21,21,0,0,0,0,2,0,13,3,16,2,20,14,91,16,0,0,107,0,6,0,0,0,0,6,6,101
Daman & Diu,1 - Rape (Section 376 IPC),2014,1,0,2,2,2,0,0,0,0,0,0,2,1,3,0,3,0,11,3,0,0,14,0,3,0,1,1,0,2,2,11
Daman & Diu,1.1 - Custodial Rape,2014,0,0,0,0,0,0,0,0,0,0,0,0,0,0,0,0,0,0,0,0,0,0,0,0,0,0,0,0,0,0,0
Daman & Diu,1.1.1 - Custodial_Gang Rape,2014,0,0,0,0,0,0,0,0,0,0,0,0,0,0,0,0,0,0,0,0,0,0,0,0,0,0,0,0,0,0,0
Daman & Diu,1.1.2 - Custodial_Other Rape,2014,0,0,0,0,0,0,0,0,0,0,0,0,0,0,0,0,0,0,0,0,0,0,0,0,0,0,0,0,0,0,0
Daman & Diu,1.2 - Rape other than Custodial,2014,1,0,2,2,2,0,0,0,0,0,0,2,1,3,0,3,0,11,3,0,0,14,0,3,0,1,1,0,2,2,11
Daman & Diu,1.2.1 - Rape_Gang Rape,2014,0,0,0,0,0,0,0,0,0,0,0,0,0,0,0,0,0,0,0,0,0,0,0,0,0,0,0,0,0,0,0
Daman & Diu,1.2.2 - Rape_Others,2014,1,0,2,2,2,0,0,0,0,0,0,2,1,3,0,3,0,11,3,0,0,14,0,3,0,1,1,0,2,2,11
Daman & Diu,2 - Attempt to commit Rape (Section 376 & 511 IPC),2014,0,0,0,0,0,0,0,0,0,0,0,0,0,0,0,0,0,0,0,0,0,0,0,0,0,0,0,0,0,0,0
Daman & Diu,"3 - Kidnapping & Abduction of Women (Section 363,364,364A, 366-369 IPC)",2014,0,0,1,1,5,0,0,0,0,0,0,0,0,0,0,0,1,0,0,0,0,0,0,0,0,0,0,0,0,0,0
Daman & Diu,3.1 - Kidnaping & Abduction Section 363 IPC,2014,0,0,1,1,5,0,0,0,0,0,0,0,0,0,0,0,1,0,0,0,0,0,0,0,0,0,0,0,0,0,0
Daman & Diu,3.2 - Kidnaping & Abduction in order to Murder Section 364 IPC,2014,0,0,0,0,0,0,0,0,0,0,0,0,0,0,0,0,0,0,0,0,0,0,0,0,0,0,0,0,0,0,0
Daman & Diu,3.3 - Kidnapping for Ransom Section 364A,2014,0,0,0,0,0,0,0,0,0,0,0,0,0,0,0,0,0,0,0,0,0,0,0,0,0,0,0,0,0,0,0
Daman & Diu,3.4 - Kidnapping & Abduction of Women to compel her for marriage,2014,0,0,0,0,0,0,0,0,0,0,0,0,0,0,0,0,0,0,0,0,0,0,0,0,0,0,0,0,0,0,0
Daman & Diu,3.5 - Kidnapping & Abduction of Women-Other,2014,0,0,0,0,0,0,0,0,0,0,0,0,0,0,0,0,0,0,0,0,0,0,0,0,0,0,0,0,0,0,0
Daman & Diu,4 - Dowry Deaths (Section 304-B IPC),2014,0,0,0,0,0,0,0,0,0,0,0,0,0,0,0,0,0,0,0,0,0,0,0,0,0,0,0,0,0,0,0
Daman & Diu,5 - Assault on Women with intent to outrage her Modesty_Total (Section 354 IPC),2014,2,0,3,3,3,0,0,0,0,0,0,2,0,2,0,2,3,0,2,0,0,2,0,0,0,0,0,0,0,0,2
Daman & Diu,5.1 - Sexual Harassment,2014,2,0,3,3,3,0,0,0,0,0,0,2,0,2,0,2,3,0,2,0,0,2,0,0,0,0,0,0,0,0,2
Daman & Diu,5.2 - Assault on women with intent to Disrobe,2014,0,0,0,0,0,0,0,0,0,0,0,0,0,0,0,0,0,0,0,0,0,0,0,0,0,0,0,0,0,0,0
Daman & Diu,5.3 - Voyeurism,2014,0,0,0,0,0,0,0,0,0,0,0,0,0,0,0,0,0,0,0,0,0,0,0,0,0,0,0,0,0,0,0
Daman & Diu,5.4 - Stalking,2014,0,0,0,0,0,0,0,0,0,0,0,0,0,0,0,0,0,0,0,0,0,0,0,0,0,0,0,0,0,0,0
Daman & Diu,5.5 - Others,2014,0,0,0,0,0,0,0,0,0,0,0,0,0,0,0,0,0,0,0,0,0,0,0,0,0,0,0,0,0,0,0
Daman & Diu,6 - Insult to the Modesty of Women_Total (Section 509 IPC),2014,0,0,0,0,0,0,0,0,0,0,0,0,0,0,0,0,0,0,0,0,0,0,0,0,0,0,0,0,0,0,0
Daman & Diu,6.1 - At Office premises,2014,0,0,0,0,0,0,0,0,0,0,0,0,0,0,0,0,0,0,0,0,0,0,0,0,0,0,0,0,0,0,0
Daman & Diu,6.2 - Other places related to work,2014,0,0,0,0,0,0,0,0,0,0,0,0,0,0,0,0,0,0,0,0,0,0,0,0,0,0,0,0,0,0,0
Daman & Diu,6.3 - In Public Transport system,2014,0,0,0,0,0,0,0,0,0,0,0,0,0,0,0,0,0,0,0,0,0,0,0,0,0,0,0,0,0,0,0
Daman & Diu,6.4 - in Other Places,2014,0,0,0,0,0,0,0,0,0,0,0,0,0,0,0,0,0,0,0,0,0,0,0,0,0,0,0,0,0,0,0
Daman & Diu,7 - Cruelty by Husband or his Relatives (Section 498A),2014,1,0,1,1,1,0,0,0,0,0,0,0,1,1,0,1,1,11,1,0,0,12,0,8,0,0,0,0,8,8,4
Daman & Diu,8 - Importation of Girls from Foreign Country (Section 366B IPC),2014,0,0,0,0,0,0,0,0,0,0,0,0,0,0,0,0,0,0,0,0,0,0,0,0,0,0,0,0,0,0,0
Daman & Diu,9 - Abetment of Suicides of Women u/s 306 IPC,2014,0,0,0,0,0,0,0,0,0,0,0,0,0,0,0,0,0,0,0,0,0,0,0,0,0,0,0,0,0,0,0
Daman & Diu,"10 - Dowry Prohibition Act, 1961",2014,0,0,0,0,0,0,0,0,0,0,0,0,0,0,0,0,0,0,0,0,0,0,0,0,0,0,0,0,0,0,0
Daman & Diu,"11 - Indecent Representation of Women (Prohibition) Act, 1986",2014,0,0,0,0,0,0,0,0,0,0,0,0,0,0,0,0,0,0,0,0,0,0,0,0,0,0,0,0,0,0,0
Daman & Diu,12 - Commission of Sati Prevention Act 1987,2014,0,0,0,0,0,0,0,0,0,0,0,0,0,0,0,0,0,0,0,0,0,0,0,0,0,0,0,0,0,0,0
Daman & Diu,"13 - Protection of Women from Domestic Violence Act, 2005",2014,0,0,0,0,0,0,0,0,0,0,0,0,0,0,0,0,0,0,0,0,0,0,0,0,0,0,0,0,0,0,0
Daman & Diu,14 - Immoral Traffic (Prevention) Act (Women Cases only),2014,6,0,8,8,8,0,0,0,0,0,0,5,3,8,0,8,6,0,8,0,0,8,0,0,0,0,0,0,0,0,8
Daman & Diu,14.1 - Under ITP Section 5,2014,6,0,8,8,8,0,0,0,0,0,0,5,3,8,0,8,6,0,8,0,0,8,0,0,0,0,0,0,0,0,8
Daman & Diu,14.2 - Under ITP Section 6,2014,0,0,0,0,0,0,0,0,0,0,0,0,0,0,0,0,0,0,0,0,0,0,0,0,0,0,0,0,0,0,0
Daman & Diu,14.3 - Under ITP Section 7,2014,0,0,0,0,0,0,0,0,0,0,0,0,0,0,0,0,0,0,0,0,0,0,0,0,0,0,0,0,0,0,0
Daman & Diu,14.4 - Under ITP Section 8,2014,0,0,0,0,0,0,0,0,0,0,0,0,0,0,0,0,0,0,0,0,0,0,0,0,0,0,0,0,0,0,0
Daman & Diu,14.5 - Other Sections under ITP Act,2014,0,0,0,0,0,0,0,0,0,0,0,0,0,0,0,0,0,0,0,0,0,0,0,0,0,0,0,0,0,0,0
Daman & Diu,15 - Total Crimes against Women,2014,10,0,15,15,19,0,0,0,0,0,0,9,5,14,0,14,11,22,14,0,0,36,0,11,0,1,1,0,10,10,25
Delhi UT,1 - Rape (Section 376 IPC),2014,498,36,2060,2096,2102,0,0,15,12,22,0,1271,565,1836,20,1890,689,2945,1836,0,0,4781,2,774,19,248,267,49,458,507,4005
Delhi UT,1.1 - Custodial Rape,2014,0,0,0,0,0,0,0,0,0,0,0,0,0,0,0,0,0,0,0,0,0,0,0,0,0,0,0,0,0,0,0
Delhi UT,1.1.1 - Custodial_Gang Rape,2014,0,0,0,0,0,0,0,0,0,0,0,0,0,0,0,0,0,0,0,0,0,0,0,0,0,0,0,0,0,0,0
Delhi UT,1.1.2 - Custodial_Other Rape,2014,0,0,0,0,0,0,0,0,0,0,0,0,0,0,0,0,0,0,0,0,0,0,0,0,0,0,0,0,0,0,0
Delhi UT,1.2 - Rape other than Custodial,2014,498,36,2060,2096,2102,0,0,15,12,22,0,1271,565,1836,20,1890,689,2945,1836,0,0,4781,2,774,19,248,267,49,458,507,4005
Delhi UT,1.2.1 - Rape_Gang Rape,2014,7,0,147,147,147,0,0,1,0,0,0,81,5,86,1,87,66,12,86,0,0,98,0,27,0,9,9,4,14,18,71
Delhi UT,1.2.2 - Rape_Others,2014,491,36,1913,1949,1955,0,0,14,12,22,0,1190,560,1750,19,1803,623,2933,1750,0,0,4683,2,747,19,239,258,45,444,489,3934
Delhi UT,2 - Attempt to commit Rape (Section 376 & 511 IPC),2014,11,0,70,70,70,0,0,0,0,1,0,54,9,63,1,65,16,11,63,0,0,74,0,9,0,4,4,0,5,5,65
Delhi UT,"3 - Kidnapping & Abduction of Women (Section 363,364,364A, 366-369 IPC)",2014,1936,0,4034,4034,4227,0,0,4,497,643,0,198,129,327,755,2222,3744,1314,327,0,0,1641,0,205,1,47,48,1,156,157,1436
Delhi UT,3.1 - Kidnaping & Abduction Section 363 IPC,2014,1812,0,3731,3731,3905,0,0,4,483,606,0,182,118,300,726,2115,3424,1235,300,0,0,1535,0,188,1,41,42,1,145,146,1347
Delhi UT,3.2 - Kidnaping & Abduction in order to Murder Section 364 IPC,2014,0,0,0,0,0,0,0,0,0,0,0,0,0,0,0,0,0,0,0,0,0,0,0,0,0,0,0,0,0,0,0
Delhi UT,3.3 - Kidnapping for Ransom Section 364A,2014,0,0,7,7,7,0,0,0,0,0,0,2,0,2,1,3,4,0,2,0,0,2,0,0,0,0,0,0,0,0,2
Delhi UT,3.4 - Kidnapping & Abduction of Women to compel her for marriage,2014,0,0,2,2,2,0,0,0,0,0,0,1,0,1,0,1,1,1,1,0,0,2,0,0,0,0,0,0,0,0,2
Delhi UT,3.5 - Kidnapping & Abduction of Women-Other,2014,124,0,294,294,313,0,0,0,14,37,0,13,11,24,28,103,315,78,24,0,0,102,0,17,0,6,6,0,11,11,85
Delhi UT,4 - Dowry Deaths (Section 304-B IPC),2014,70,3,150,153,153,0,0,0,0,0,0,95,51,146,2,148,75,693,146,0,0,839,1,70,0,27,27,4,39,43,768
Delhi UT,5 - Assault on Women with intent to outrage her Modesty_Total (Section 354 IPC),2014,1099,45,4277,4322,4330,0,0,0,10,24,0,1606,816,2422,256,2712,2709,5262,2422,4,17,7663,27,948,83,292,375,85,488,573,6688
Delhi UT,5.1 - Sexual Harassment,2014,141,4,1182,1186,1186,0,0,0,3,11,0,456,144,600,136,750,577,1055,600,2,16,1637,6,132,17,47,64,22,46,68,1499
Delhi UT,5.2 - Assault on women with intent to Disrobe,2014,36,4,375,379,379,0,0,0,0,3,0,130,35,165,1,169,246,98,165,0,0,263,2,31,7,5,12,5,14,19,230
Delhi UT,5.3 - Voyeurism,2014,22,3,31,34,34,0,0,0,0,0,0,16,8,24,0,24,32,21,24,0,0,45,1,3,1,0,1,1,1,2,41
Delhi UT,5.4 - Stalking,2014,63,0,541,541,541,0,0,0,0,2,0,210,54,264,9,275,329,86,264,0,0,350,2,53,14,10,24,17,12,29,295
Delhi UT,5.5 - Others,2014,837,34,2148,2182,2190,0,0,0,7,8,0,794,575,1369,110,1494,1525,4002,1369,2,1,5368,16,729,44,230,274,40,415,455,4623
Delhi UT,6 - Insult to the Modesty of Women_Total (Section 509 IPC),2014,247,3,1358,1361,1364,0,0,1,2,3,0,486,148,634,63,702,905,1111,634,0,12,1733,9,318,29,97,126,60,132,192,1406
Delhi UT,6.1 - At Office premises,2014,2,0,11,11,11,0,0,0,0,0,0,3,4,7,1,8,5,32,7,0,0,39,0,2,0,2,2,0,0,0,37
Delhi UT,6.2 - Other places related to work,2014,7,0,25,25,25,0,0,0,0,2,0,7,2,9,1,12,20,28,9,0,0,37,0,4,0,2,2,0,2,2,33
Delhi UT,6.3 - In Public Transport system,2014,4,0,8,8,8,0,0,0,0,0,0,4,4,8,2,10,2,6,8,0,0,14,2,4,0,1,1,0,3,3,8
Delhi UT,6.4 - in Other Places,2014,234,3,1314,1317,1320,0,0,1,2,1,0,472,138,610,59,672,878,1045,610,0,12,1643,7,308,29,92,121,60,127,187,1328
Delhi UT,7 - Cruelty by Husband or his Relatives (Section 498A),2014,3688,19,3154,3173,3173,0,0,0,61,13,0,157,783,940,66,1080,5781,5065,940,18,16,5971,91,790,7,139,146,1,643,644,5090
Delhi UT,8 - Importation of Girls from Foreign Country (Section 366B IPC),2014,0,0,0,0,0,0,0,0,0,0,0,0,0,0,0,0,0,0,0,0,0,0,0,0,0,0,0,0,0,0,0
Delhi UT,9 - Abetment of Suicides of Women u/s 306 IPC,2014,5,1,27,28,28,0,0,0,0,0,0,4,1,5,0,5,28,13,5,0,0,18,0,0,0,0,0,0,0,0,18
Delhi UT,"10 - Dowry Prohibition Act, 1961",2014,19,0,13,13,13,0,0,0,0,2,0,2,6,8,3,13,19,62,8,0,0,70,0,3,0,0,0,0,3,3,67
Delhi UT,"11 - Indecent Representation of Women (Prohibition) Act, 1986",2014,4,0,0,0,0,0,0,0,0,1,0,0,0,0,3,4,0,0,0,0,0,0,0,0,0,0,0,0,0,0,0
Delhi UT,12 - Commission of Sati Prevention Act 1987,2014,0,0,0,0,0,0,0,0,0,0,0,0,0,0,0,0,0,0,0,0,0,0,0,0,0,0,0,0,0,0,0
Delhi UT,"13 - Protection of Women from Domestic Violence Act, 2005",2014,0,0,7,7,7,0,0,0,0,0,0,2,0,2,0,2,5,0,2,0,0,2,0,1,0,1,1,0,0,0,1
Delhi UT,14 - Immoral Traffic (Prevention) Act (Women Cases only),2014,10,0,8,8,13,0,0,0,0,0,0,3,9,12,0,12,6,191,12,0,0,203,0,22,0,11,11,0,11,11,181
Delhi UT,14.1 - Under ITP Section 5,2014,4,0,6,6,11,0,0,0,0,0,0,3,4,7,0,7,3,68,7,0,0,75,0,4,0,2,2,0,2,2,71
Delhi UT,14.2 - Under ITP Section 6,2014,0,0,0,0,0,0,0,0,0,0,0,0,0,0,0,0,0,0,0,0,0,0,0,0,0,0,0,0,0,0,0
Delhi UT,14.3 - Under ITP Section 7,2014,0,0,0,0,0,0,0,0,0,0,0,0,0,0,0,0,0,0,0,0,0,0,0,0,0,0,0,0,0,0,0
Delhi UT,14.4 - Under ITP Section 8,2014,0,0,1,1,1,0,0,0,0,0,0,0,0,0,0,0,1,51,0,0,0,51,0,6,0,0,0,0,6,6,45
Delhi UT,14.5 - Other Sections under ITP Act,2014,6,0,1,1,1,0,0,0,0,0,0,0,5,5,0,5,2,72,5,0,0,77,0,12,0,9,9,0,3,3,65
Delhi UT,15 - Total Crimes against Women,2014,7587,107,15158,15265,15480,0,0,20,582,709,0,3878,2517,6395,1169,8855,13977,16667,6395,22,45,22995,130,3140,139,866,1005,200,1935,2135,19725
Lakshadweep,1 - Rape (Section 376 IPC),2014,2,0,1,1,1,0,0,0,0,0,0,1,0,1,0,1,2,0,1,0,0,1,0,0,0,0,0,0,0,0,1
Lakshadweep,1.1 - Custodial Rape,2014,0,0,0,0,0,0,0,0,0,0,0,0,0,0,0,0,0,0,0,0,0,0,0,0,0,0,0,0,0,0,0
Lakshadweep,1.1.1 - Custodial_Gang Rape,2014,0,0,0,0,0,0,0,0,0,0,0,0,0,0,0,0,0,0,0,0,0,0,0,0,0,0,0,0,0,0,0
Lakshadweep,1.1.2 - Custodial_Other Rape,2014,0,0,0,0,0,0,0,0,0,0,0,0,0,0,0,0,0,0,0,0,0,0,0,0,0,0,0,0,0,0,0
Lakshadweep,1.2 - Rape other than Custodial,2014,2,0,1,1,1,0,0,0,0,0,0,1,0,1,0,1,2,0,1,0,0,1,0,0,0,0,0,0,0,0,1
Lakshadweep,1.2.1 - Rape_Gang Rape,2014,0,0,0,0,0,0,0,0,0,0,0,0,0,0,0,0,0,0,0,0,0,0,0,0,0,0,0,0,0,0,0
Lakshadweep,1.2.2 - Rape_Others,2014,2,0,1,1,1,0,0,0,0,0,0,1,0,1,0,1,2,0,1,0,0,1,0,0,0,0,0,0,0,0,1
Lakshadweep,2 - Attempt to commit Rape (Section 376 & 511 IPC),2014,0,0,0,0,0,0,0,0,0,0,0,0,0,0,0,0,0,0,0,0,0,0,0,0,0,0,0,0,0,0,0
Lakshadweep,"3 - Kidnapping & Abduction of Women (Section 363,364,364A, 366-369 IPC)",2014,0,0,0,0,0,0,0,0,0,0,0,0,0,0,0,0,0,0,0,0,0,0,0,0,0,0,0,0,0,0,0
Lakshadweep,3.1 - Kidnaping & Abduction Section 363 IPC,2014,0,0,0,0,0,0,0,0,0,0,0,0,0,0,0,0,0,0,0,0,0,0,0,0,0,0,0,0,0,0,0
Lakshadweep,3.2 - Kidnaping & Abduction in order to Murder Section 364 IPC,2014,0,0,0,0,0,0,0,0,0,0,0,0,0,0,0,0,0,0,0,0,0,0,0,0,0,0,0,0,0,0,0
Lakshadweep,3.3 - Kidnapping for Ransom Section 364A,2014,0,0,0,0,0,0,0,0,0,0,0,0,0,0,0,0,0,0,0,0,0,0,0,0,0,0,0,0,0,0,0
Lakshadweep,3.4 - Kidnapping & Abduction of Women to compel her for marriage,2014,0,0,0,0,0,0,0,0,0,0,0,0,0,0,0,0,0,0,0,0,0,0,0,0,0,0,0,0,0,0,0
Lakshadweep,3.5 - Kidnapping & Abduction of Women-Other,2014,0,0,0,0,0,0,0,0,0,0,0,0,0,0,0,0,0,0,0,0,0,0,0,0,0,0,0,0,0,0,0
Lakshadweep,4 - Dowry Deaths (Section 304-B IPC),2014,0,0,0,0,0,0,0,0,0,0,0,0,0,0,0,0,0,0,0,0,0,0,0,0,0,0,0,0,0,0,0
Lakshadweep,5 - Assault on Women with intent to outrage her Modesty_Total (Section 354 IPC),2014,1,0,1,1,2,0,0,0,0,0,0,1,1,2,0,2,0,0,2,0,0,2,0,0,0,0,0,0,0,0,2
Lakshadweep,5.1 - Sexual Harassment,2014,0,0,0,0,0,0,0,0,0,0,0,0,0,0,0,0,0,0,0,0,0,0,0,0,0,0,0,0,0,0,0
Lakshadweep,5.2 - Assault on women with intent to Disrobe,2014,0,0,0,0,0,0,0,0,0,0,0,0,0,0,0,0,0,0,0,0,0,0,0,0,0,0,0,0,0,0,0
Lakshadweep,5.3 - Voyeurism,2014,0,0,0,0,0,0,0,0,0,0,0,0,0,0,0,0,0,0,0,0,0,0,0,0,0,0,0,0,0,0,0
Lakshadweep,5.4 - Stalking,2014,0,0,0,0,0,0,0,0,0,0,0,0,0,0,0,0,0,0,0,0,0,0,0,0,0,0,0,0,0,0,0
Lakshadweep,5.5 - Others,2014,1,0,1,1,2,0,0,0,0,0,0,1,1,2,0,2,0,0,2,0,0,2,0,0,0,0,0,0,0,0,2
Lakshadweep,6 - Insult to the Modesty of Women_Total (Section 509 IPC),2014,0,0,2,2,2,0,0,0,0,0,0,0,0,0,0,0,2,0,0,0,0,0,0,0,0,0,0,0,0,0,0
Lakshadweep,6.1 - At Office premises,2014,0,0,0,0,0,0,0,0,0,0,0,0,0,0,0,0,0,0,0,0,0,0,0,0,0,0,0,0,0,0,0
Lakshadweep,6.2 - Other places related to work,2014,0,0,0,0,0,0,0,0,0,0,0,0,0,0,0,0,0,0,0,0,0,0,0,0,0,0,0,0,0,0,0
Lakshadweep,6.3 - In Public Transport system,2014,0,0,0,0,0,0,0,0,0,0,0,0,0,0,0,0,0,0,0,0,0,0,0,0,0,0,0,0,0,0,0
Lakshadweep,6.4 - in Other Places,2014,0,0,2,2,2,0,0,0,0,0,0,0,0,0,0,0,2,0,0,0,0,0,0,0,0,0,0,0,0,0,0
Lakshadweep,7 - Cruelty by Husband or his Relatives (Section 498A),2014,0,0,0,0,0,0,0,0,0,0,0,0,0,0,0,0,0,1,0,0,0,1,0,0,0,0,0,0,0,0,1
Lakshadweep,8 - Importation of Girls from Foreign Country (Section 366B IPC),2014,0,0,0,0,0,0,0,0,0,0,0,0,0,0,0,0,0,0,0,0,0,0,0,0,0,0,0,0,0,0,0
Lakshadweep,9 - Abetment of Suicides of Women u/s 306 IPC,2014,0,0,0,0,0,0,0,0,0,0,0,0,0,0,0,0,0,0,0,0,0,0,0,0,0,0,0,0,0,0,0
Lakshadweep,"10 - Dowry Prohibition Act, 1961",2014,0,0,0,0,0,0,0,0,0,0,0,0,0,0,0,0,0,0,0,0,0,0,0,0,0,0,0,0,0,0,0
Lakshadweep,"11 - Indecent Representation of Women (Prohibition) Act, 1986",2014,0,0,0,0,0,0,0,0,0,0,0,0,0,0,0,0,0,0,0,0,0,0,0,0,0,0,0,0,0,0,0
Lakshadweep,12 - Commission of Sati Prevention Act 1987,2014,0,0,0,0,0,0,0,0,0,0,0,0,0,0,0,0,0,0,0,0,0,0,0,0,0,0,0,0,0,0,0
Lakshadweep,"13 - Protection of Women from Domestic Violence Act, 2005",2014,0,0,0,0,0,0,0,0,0,0,0,0,0,0,0,0,0,0,0,0,0,0,0,0,0,0,0,0,0,0,0
Lakshadweep,14 - Immoral Traffic (Prevention) Act (Women Cases only),2014,0,0,0,0,0,0,0,0,0,0,0,0,0,0,0,0,0,0,0,0,0,0,0,0,0,0,0,0,0,0,0
Lakshadweep,14.1 - Under ITP Section 5,2014,0,0,0,0,0,0,0,0,0,0,0,0,0,0,0,0,0,0,0,0,0,0,0,0,0,0,0,0,0,0,0
Lakshadweep,14.2 - Under ITP Section 6,2014,0,0,0,0,0,0,0,0,0,0,0,0,0,0,0,0,0,0,0,0,0,0,0,0,0,0,0,0,0,0,0
Lakshadweep,14.3 - Under ITP Section 7,2014,0,0,0,0,0,0,0,0,0,0,0,0,0,0,0,0,0,0,0,0,0,0,0,0,0,0,0,0,0,0,0
Lakshadweep,14.4 - Under ITP Section 8,2014,0,0,0,0,0,0,0,0,0,0,0,0,0,0,0,0,0,0,0,0,0,0,0,0,0,0,0,0,0,0,0
Lakshadweep,14.5 - Other Sections under ITP Act,2014,0,0,0,0,0,0,0,0,0,0,0,0,0,0,0,0,0,0,0,0,0,0,0,0,0,0,0,0,0,0,0
Lakshadweep,15 - Total Crimes against Women,2014,3,0,4,4,5,0,0,0,0,0,0,2,1,3,0,3,4,1,3,0,0,4,0,0,0,0,0,0,0,0,4
Puducherry,1 - Rape (Section 376 IPC),2014,6,1,9,10,10,0,0,1,0,0,0,4,3,7,0,7,8,12,7,0,0,19,0,2,0,0,0,1,1,2,17
Puducherry,1.1 - Custodial Rape,2014,3,1,0,1,1,0,0,0,0,0,0,1,3,4,0,4,0,6,4,0,0,10,0,1,0,0,0,0,1,1,9
Puducherry,1.1.1 - Custodial_Gang Rape,2014,0,0,0,0,0,0,0,0,0,0,0,0,0,0,0,0,0,0,0,0,0,0,0,0,0,0,0,0,0,0,0
Puducherry,1.1.2 - Custodial_Other Rape,2014,3,1,0,1,1,0,0,0,0,0,0,1,3,4,0,4,0,6,4,0,0,10,0,1,0,0,0,0,1,1,9
Puducherry,1.2 - Rape other than Custodial,2014,3,0,9,9,9,0,0,1,0,0,0,3,0,3,0,3,8,6,3,0,0,9,0,1,0,0,0,1,0,1,8
Puducherry,1.2.1 - Rape_Gang Rape,2014,0,0,1,1,1,0,0,1,0,0,0,0,0,0,0,0,0,0,0,0,0,0,0,0,0,0,0,0,0,0,0
Puducherry,1.2.2 - Rape_Others,2014,3,0,8,8,8,0,0,0,0,0,0,3,0,3,0,3,8,6,3,0,0,9,0,1,0,0,0,1,0,1,8
Puducherry,2 - Attempt to commit Rape (Section 376 & 511 IPC),2014,0,0,0,0,0,0,0,0,0,0,0,0,0,0,0,0,0,0,0,0,0,0,0,0,0,0,0,0,0,0,0
Puducherry,"3 - Kidnapping & Abduction of Women (Section 363,364,364A, 366-369 IPC)",2014,0,0,7,7,7,0,0,0,2,1,0,2,0,2,0,5,2,7,2,0,0,9,0,0,0,0,0,0,0,0,9
Puducherry,3.1 - Kidnaping & Abduction Section 363 IPC,2014,0,0,4,4,4,0,0,0,0,1,0,1,0,1,0,2,2,0,1,0,0,1,0,0,0,0,0,0,0,0,1
Puducherry,3.2 - Kidnaping & Abduction in order to Murder Section 364 IPC,2014,0,0,0,0,0,0,0,0,0,0,0,0,0,0,0,0,0,0,0,0,0,0,0,0,0,0,0,0,0,0,0
Puducherry,3.3 - Kidnapping for Ransom Section 364A,2014,0,0,0,0,0,0,0,0,0,0,0,0,0,0,0,0,0,0,0,0,0,0,0,0,0,0,0,0,0,0,0
Puducherry,3.4 - Kidnapping & Abduction of Women to compel her for marriage,2014,0,0,1,1,1,0,0,0,0,0,0,1,0,1,0,1,0,7,1,0,0,8,0,0,0,0,0,0,0,0,8
Puducherry,3.5 - Kidnapping & Abduction of Women-Other,2014,0,0,2,2,2,0,0,0,2,0,0,0,0,0,0,2,0,0,0,0,0,0,0,0,0,0,0,0,0,0,0
Puducherry,4 - Dowry Deaths (Section 304-B IPC),2014,0,0,1,1,1,0,0,0,0,0,0,0,0,0,0,0,1,3,0,0,0,3,0,0,0,0,0,0,0,0,3
Puducherry,5 - Assault on Women with intent to outrage her Modesty_Total (Section 354 IPC),2014,10,1,31,32,33,0,0,0,0,2,0,26,1,27,1,30,12,69,27,0,0,96,0,5,0,0,0,0,5,5,91
Puducherry,5.1 - Sexual Harassment,2014,3,0,12,12,12,0,0,0,0,1,0,9,1,10,1,12,3,15,10,0,0,25,0,0,0,0,0,0,0,0,25
Puducherry,5.2 - Assault on women with intent to Disrobe,2014,7,0,6,6,6,0,0,0,0,0,0,5,0,5,0,5,8,1,5,0,0,6,0,0,0,0,0,0,0,0,6
Puducherry,5.3 - Voyeurism,2014,0,0,1,1,1,0,0,0,0,0,0,1,0,1,0,1,0,0,1,0,0,1,0,0,0,0,0,0,0,0,1
Puducherry,5.4 - Stalking,2014,0,0,1,1,1,0,0,0,0,0,0,1,0,1,0,1,0,0,1,0,0,1,0,0,0,0,0,0,0,0,1
Puducherry,5.5 - Others,2014,0,1,11,12,13,0,0,0,0,1,0,10,0,10,0,11,1,53,10,0,0,63,0,5,0,0,0,0,5,5,58
Puducherry,6 - Insult to the Modesty of Women_Total (Section 509 IPC),2014,3,0,8,8,12,0,0,0,0,0,0,5,2,7,1,8,3,15,7,0,0,22,0,1,0,1,1,0,0,0,21
Puducherry,6.1 - At Office premises,2014,0,0,1,1,4,0,0,0,0,0,0,1,0,1,0,1,0,0,1,0,0,1,0,0,0,0,0,0,0,0,1
Puducherry,6.2 - Other places related to work,2014,0,0,2,2,2,0,0,0,0,0,0,2,0,2,0,2,0,0,2,0,0,2,0,1,0,1,1,0,0,0,1
Puducherry,6.3 - In Public Transport system,2014,0,0,0,0,0,0,0,0,0,0,0,0,0,0,0,0,0,1,0,0,0,1,0,0,0,0,0,0,0,0,1
Puducherry,6.4 - in Other Places,2014,3,0,5,5,6,0,0,0,0,0,0,2,2,4,1,5,3,14,4,0,0,18,0,0,0,0,0,0,0,0,18
Puducherry,7 - Cruelty by Husband or his Relatives (Section 498A),2014,3,0,4,4,4,0,0,0,0,0,0,1,3,4,0,4,3,4,4,0,0,8,0,0,0,0,0,0,0,0,8
Puducherry,8 - Importation of Girls from Foreign Country (Section 366B IPC),2014,0,0,0,0,0,0,0,0,0,0,0,0,0,0,0,0,0,0,0,0,0,0,0,0,0,0,0,0,0,0,0
Puducherry,9 - Abetment of Suicides of Women u/s 306 IPC,2014,0,0,0,0,0,0,0,0,0,0,0,0,0,0,0,0,0,0,0,0,0,0,0,0,0,0,0,0,0,0,0
Puducherry,"10 - Dowry Prohibition Act, 1961",2014,3,2,12,14,14,0,0,0,0,0,0,7,2,9,0,9,8,2,9,0,0,11,0,0,0,0,0,0,0,0,11
Puducherry,"11 - Indecent Representation of Women (Prohibition) Act, 1986",2014,0,0,0,0,0,0,0,0,0,0,0,0,0,0,0,0,0,0,0,0,0,0,0,0,0,0,0,0,0,0,0
Puducherry,12 - Commission of Sati Prevention Act 1987,2014,0,0,0,0,0,0,0,0,0,0,0,0,0,0,0,0,0,0,0,0,0,0,0,0,0,0,0,0,0,0,0
Puducherry,"13 - Protection of Women from Domestic Violence Act, 2005",2014,0,0,0,0,0,0,0,0,0,0,0,0,0,0,0,0,0,0,0,0,0,0,0,0,0,0,0,0,0,0,0
Puducherry,14 - Immoral Traffic (Prevention) Act (Women Cases only),2014,0,0,1,1,1,0,0,0,0,0,0,1,0,1,0,1,0,0,1,0,0,1,0,0,0,0,0,0,0,0,1
Puducherry,14.1 - Under ITP Section 5,2014,0,0,0,0,0,0,0,0,0,0,0,0,0,0,0,0,0,0,0,0,0,0,0,0,0,0,0,0,0,0,0
Puducherry,14.2 - Under ITP Section 6,2014,0,0,1,1,1,0,0,0,0,0,0,1,0,1,0,1,0,0,1,0,0,1,0,0,0,0,0,0,0,0,1
Puducherry,14.3 - Under ITP Section 7,2014,0,0,0,0,0,0,0,0,0,0,0,0,0,0,0,0,0,0,0,0,0,0,0,0,0,0,0,0,0,0,0
Puducherry,14.4 - Under ITP Section 8,2014,0,0,0,0,0,0,0,0,0,0,0,0,0,0,0,0,0,0,0,0,0,0,0,0,0,0,0,0,0,0,0
Puducherry,14.5 - Other Sections under ITP Act,2014,0,0,0,0,0,0,0,0,0,0,0,0,0,0,0,0,0,0,0,0,0,0,0,0,0,0,0,0,0,0,0
Puducherry,15 - Total Crimes against Women,2014,25,4,73,77,82,0,0,1,2,3,0,46,11,57,2,64,37,112,57,0,0,169,0,8,0,1,1,1,6,7,161
Total (States),1 - Rape (Section 376 IPC),2014,14519,2435,32095,34530,34764,9,1,139,2528,745,19,21441,7467,28908,1401,33601,15299,91515,28908,3,40,120380,251,16807,844,3817,4661,2011,10135,12146,103322
Total (States),1.1 - Custodial Rape,2014,0,4,192,196,196,0,0,0,3,8,0,154,0,154,8,173,23,11,154,0,0,165,0,4,0,3,3,0,1,1,161
Total (States),1.1.1 - Custodial_Gang Rape,2014,0,0,7,7,7,0,0,0,1,0,0,5,0,5,0,6,1,1,5,0,0,6,0,1,0,1,1,0,0,0,5
Total (States),1.1.2 - Custodial_Other Rape,2014,0,4,185,189,189,0,0,0,2,8,0,149,0,149,8,167,22,10,149,0,0,159,0,3,0,2,2,0,1,1,156
Total (States),1.2 - Rape other than Custodial,2014,14519,2431,31903,34334,34568,9,1,139,2520,737,24,21287,7467,28754,1393,33428,15276,91504,28754,3,40,120215,251,16803,844,3814,4658,2011,10134,12145,103161
Total (States),1.2.1 - Rape_Gang Rape,2014,204,151,2046,2197,2212,0,0,4,298,118,0,1291,146,1437,58,1911,486,1108,1437,0,0,2545,4,325,22,97,119,60,146,206,2216
Total (States),1.2.2 - Rape_Others,2014,14315,2280,29857,32137,32356,9,1,135,2227,619,19,19996,7321,27317,1335,31517,14790,90396,27317,3,40,117670,247,16478,822,3717,4539,1951,9988,11939,100945
Total (States),2 - Attempt to commit Rape (Section 376 & 511 IPC),2014,423,776,3382,4158,4158,0,0,1,323,71,14,2306,408,2714,175,3297,1283,2009,2714,0,1,4722,29,1004,57,86,143,149,712,861,3689
Total (States),"3 - Kidnapping & Abduction of Women (Section 363,364,364A, 366-369 IPC)",2014,25456,2337,50775,53112,54081,27,2,91,5998,5856,292,16391,9260,25651,8948,46745,31703,81622,25651,9,103,107161,387,11527,290,2310,2600,1164,7763,8927,95247
Total (States),3.1 - Kidnaping & Abduction Section 363 IPC,2014,4772,290,12888,13178,13541,2,0,36,1733,1552,50,3828,1951,5779,2055,11169,6743,17467,5779,0,4,23242,68,2260,58,510,568,192,1500,1692,20914
Total (States),3.2 - Kidnaping & Abduction in order to Murder Section 364 IPC,2014,46,19,187,206,207,0,0,0,40,39,0,87,7,94,14,187,65,289,94,0,0,383,0,37,9,7,16,10,11,21,346
Total (States),3.3 - Kidnapping for Ransom Section 364A,2014,63,1,83,84,84,0,0,1,2,2,0,37,18,55,1,60,86,185,55,0,0,240,0,9,0,2,2,1,6,7,231
Total (States),3.4 - Kidnapping & Abduction of Women to compel her for marriage,2014,16909,1588,29240,30828,30911,24,2,29,2758,3511,167,9767,6020,15787,5875,28098,19584,50767,15787,0,99,66455,248,7769,185,1595,1780,792,5197,5989,58438
Total (States),3.5 - Kidnapping & Abduction of Women-Other,2014,3666,439,8377,8816,9338,1,0,25,1465,752,75,2672,1264,3936,1003,7231,5225,12914,3936,9,0,16841,71,1452,38,196,234,169,1049,1218,15318
Total (States),4 - Dowry Deaths (Section 304-B IPC),2014,4755,302,7994,8296,8342,0,0,12,180,240,45,4872,2630,7502,477,8444,4595,32136,7502,1,18,39619,160,4988,141,1502,1643,228,3117,3345,34471
Total (States),5 - Assault on Women with intent to outrage her Modesty_Total (Section 354 IPC),2014,17835,3849,73898,77747,78122,2,1,80,4631,1620,171,52571,11309,63880,3190,73492,22007,186970,63880,8,1028,249814,3732,28923,1173,6840,8013,2580,18330,20910,217159
Total (States),5.1 - Sexual Harassment,2014,2826,644,20044,20688,20769,1,1,22,763,379,41,14838,2068,16906,736,18825,4665,29416,16906,1,266,46055,1267,4931,340,1346,1686,770,2475,3245,39857
Total (States),5.2 - Assault on women with intent to Disrobe,2014,603,309,5714,6023,6051,0,0,1,257,145,15,3964,313,4277,424,5118,1507,3269,4277,0,10,7536,124,726,27,114,141,128,457,585,6686
Total (States),5.3 - Voyeurism,2014,135,17,619,636,641,0,0,0,21,7,0,406,38,444,21,493,278,303,444,0,2,745,7,64,3,20,23,18,23,41,674
Total (States),5.4 - Stalking,2014,281,43,4100,4143,4153,0,0,4,109,48,2,2927,245,3172,132,3463,957,1514,3172,0,15,4671,49,325,36,72,108,95,122,217,4297
Total (States),5.5 - Others,2014,13990,2836,43421,46257,46508,1,0,53,3481,1041,113,30436,8645,39081,1877,45593,14600,152468,39081,7,735,190807,2285,22877,767,5288,6055,1569,15253,16822,165645
Total (States),6 - Insult to the Modesty of Women_Total (Section 509 IPC),2014,2982,97,8259,8356,8410,0,0,9,467,74,15,5366,2123,7489,303,8348,2981,27488,7489,4,96,34877,1724,5416,267,812,1079,663,3674,4337,27737
Total (States),6.1 - At Office premises,2014,13,0,45,45,45,0,0,0,2,0,0,28,6,34,0,36,22,134,34,0,0,168,2,7,0,0,0,0,7,7,159
Total (States),6.2 - Other places related to work,2014,214,2,440,442,442,0,0,1,14,1,0,201,197,398,27,440,215,1420,398,0,1,1817,85,277,6,64,70,20,187,207,1455
Total (States),6.3 - In Public Transport system,2014,23,2,111,113,113,0,0,2,6,0,0,47,47,94,14,114,20,372,94,0,0,466,8,57,4,10,14,5,38,43,401
Total (States),6.4 - in Other Places,2014,2732,93,7663,7756,7810,0,0,6,445,73,15,5090,1873,6963,262,7758,2724,25562,6963,4,95,32426,1629,5075,257,738,995,638,3442,4080,25722
Total (States),7 - Cruelty by Husband or his Relatives (Section 498A),2014,42547,25343,94195,119538,119906,16,1,449,8083,4086,137,67957,28107,96064,8262,116632,44987,399387,96064,16,2179,493256,8820,45976,549,5719,6268,3869,35839,39708,438460
Total (States),8 - Importation of Girls from Foreign Country (Section 366B IPC),2014,46,1,12,13,13,0,0,0,0,7,3,11,9,20,5,35,24,204,20,0,0,224,1,30,1,5,6,0,24,24,193
Total (States),9 - Abetment of Suicides of Women u/s 306 IPC,2014,534,18,3686,3704,3717,0,0,6,97,29,11,1973,423,2396,58,2591,1641,6727,2396,0,0,9123,7,1014,45,109,154,62,798,860,8102
Total (States),"10 - Dowry Prohibition Act, 1961",2014,5938,1398,8623,10021,10117,3,0,76,447,296,35,5346,3644,8990,980,10748,5132,22739,8990,0,71,31658,687,4614,30,442,472,310,3832,4142,26357
Total (States),"11 - Indecent Representation of Women (Prohibition) Act, 1986",2014,52,0,47,47,47,0,0,0,2,1,0,33,21,54,4,61,38,926,54,0,0,980,1,169,1,78,79,0,90,90,810
Total (States),12 - Commission of Sati Prevention Act 1987,2014,0,0,0,0,0,0,0,0,0,0,0,0,0,0,0,0,0,1,0,0,0,1,0,1,0,0,0,0,1,1,0
Total (States),"13 - Protection of Women from Domestic Violence Act, 2005",2014,33,91,328,419,423,0,0,2,18,4,6,290,20,310,9,347,103,171,310,0,2,479,5,46,5,3,8,20,18,38,428
Total (States),14 - Immoral Traffic (Prevention) Act (Women Cases only),2014,617,0,2052,2052,2732,0,0,1,3,7,1,1492,368,1860,19,1890,778,4543,1860,0,1,6402,3,927,251,199,450,38,439,477,5472
Total (States),14.1 - Under ITP Section 5,2014,190,0,590,590,869,0,0,0,0,3,0,388,124,512,11,526,254,1191,512,0,0,1703,3,201,13,47,60,6,135,141,1499
Total (States),14.2 - Under ITP Section 6,2014,9,0,80,80,120,0,0,0,0,0,0,63,9,72,0,72,17,113,72,0,0,185,0,17,1,4,5,0,12,12,168
Total (States),14.3 - Under ITP Section 7,2014,25,0,120,120,143,0,0,0,0,0,0,84,22,106,1,107,38,433,106,0,0,539,0,30,1,10,11,2,17,19,509
Total (States),14.4 - Under ITP Section 8,2014,4,0,103,103,113,0,0,0,2,0,0,90,3,93,0,95,12,352,93,0,0,445,0,64,31,22,53,0,11,11,381
Total (States),14.5 - Other Sections under ITP Act,2014,389,0,1159,1159,1487,0,0,1,1,4,1,867,210,1077,7,1090,457,2454,1077,0,1,3530,0,615,205,116,321,30,264,294,2915
Total (States),15 - Total Crimes against Women,2014,115737,36647,285346,321993,324832,57,5,866,22777,13036,749,180049,65789,245838,23831,306231,130571,856438,245838,41,3539,1098696,15807,121442,3654,21922,25576,11094,84772,95866,961447
Total (UTs),1 - Rape (Section 376 IPC),2014,533,38,2167,2205,2211,0,0,16,12,23,0,1330,602,1932,22,1989,733,3121,1932,0,0,5053,2,842,22,261,283,57,502,559,4209
Total (UTs),1.1 - Custodial Rape,2014,3,1,0,1,1,0,0,0,0,0,0,1,3,4,0,4,0,6,4,0,0,10,0,1,0,0,0,0,1,1,9
Total (UTs),1.1.1 - Custodial_Gang Rape,2014,0,0,0,0,0,0,0,0,0,0,0,0,0,0,0,0,0,0,0,0,0,0,0,0,0,0,0,0,0,0,0
Total (UTs),1.1.2 - Custodial_Other Rape,2014,3,1,0,1,1,0,0,0,0,0,0,1,3,4,0,4,0,6,4,0,0,10,0,1,0,0,0,0,1,1,9
Total (UTs),1.2 - Rape other than Custodial,2014,530,37,2167,2204,2210,0,0,16,12,23,0,1329,599,1928,22,1985,733,3115,1928,0,0,5043,2,841,22,261,283,57,501,558,4200
Total (UTs),1.2.1 - Rape_Gang Rape,2014,7,0,149,149,149,0,0,2,0,0,0,82,5,87,1,88,66,12,87,0,0,99,0,27,0,9,9,4,14,18,72
Total (UTs),1.2.2 - Rape_Others,2014,523,37,2018,2055,2061,0,0,14,12,23,0,1247,594,1841,21,1897,667,3103,1841,0,0,4944,2,814,22,252,274,53,487,540,4128
Total (UTs),2 - Attempt to commit Rape (Section 376 & 511 IPC),2014,16,0,76,76,76,0,0,0,0,3,0,57,10,67,2,72,20,17,67,0,0,84,0,12,0,6,6,1,5,6,72
Total (UTs),"3 - Kidnapping & Abduction of Women (Section 363,364,364A, 366-369 IPC)",2014,2040,0,4199,4199,4411,0,0,4,499,738,0,229,164,393,775,2405,3830,1481,393,0,0,1874,0,264,1,54,55,11,198,209,1610
Total (UTs),3.1 - Kidnaping & Abduction Section 363 IPC,2014,1833,0,3838,3838,4020,0,0,4,483,661,0,193,126,319,734,2197,3470,1342,319,0,0,1661,0,232,1,45,46,3,183,186,1429
Total (UTs),3.2 - Kidnaping & Abduction in order to Murder Section 364 IPC,2014,0,0,0,0,0,0,0,0,0,0,0,0,0,0,0,0,0,0,0,0,0,0,0,0,0,0,0,0,0,0,0
Total (UTs),3.3 - Kidnapping for Ransom Section 364A,2014,0,0,7,7,7,0,0,0,0,0,0,2,0,2,1,3,4,0,2,0,0,2,0,0,0,0,0,0,0,0,2
Total (UTs),3.4 - Kidnapping & Abduction of Women to compel her for marriage,2014,71,0,46,46,46,0,0,0,0,39,0,12,23,35,6,80,37,44,35,0,0,79,0,12,0,3,3,8,1,9,67
Total (UTs),3.5 - Kidnapping & Abduction of Women-Other,2014,136,0,308,308,338,0,0,0,16,38,0,22,15,37,34,125,319,95,37,0,0,132,0,20,0,6,6,0,14,14,112
Total (UTs),4 - Dowry Deaths (Section 304-B IPC),2014,72,3,156,159,159,0,0,0,0,0,0,98,53,151,2,153,78,707,151,0,0,858,1,73,0,29,29,4,40,44,784
Total (UTs),5 - Assault on Women with intent to outrage her Modesty_Total (Section 354 IPC),2014,1176,47,4441,4488,4498,0,0,0,10,41,0,1712,870,2582,263,2896,2768,5729,2582,4,17,8290,27,1072,90,319,409,94,569,663,7191
Total (UTs),5.1 - Sexual Harassment,2014,155,5,1245,1250,1250,0,0,0,3,13,0,496,159,655,137,808,597,1152,655,2,16,1789,6,172,21,53,74,26,72,98,1611
Total (UTs),5.2 - Assault on women with intent to Disrobe,2014,43,4,385,389,389,0,0,0,0,3,0,137,35,172,1,176,256,106,172,0,0,278,2,36,7,8,15,5,16,21,240
Total (UTs),5.3 - Voyeurism,2014,22,3,35,38,38,0,0,0,0,0,0,19,8,27,0,27,33,21,27,0,0,48,1,3,1,0,1,1,1,2,44
Total (UTs),5.4 - Stalking,2014,65,0,556,556,556,0,0,0,0,2,0,219,55,274,9,285,336,94,274,0,0,368,2,60,15,11,26,18,16,34,306
Total (UTs),5.5 - Others,2014,891,35,2220,2255,2265,0,0,0,7,23,0,841,613,1454,116,1600,1546,4356,1454,2,1,5807,16,801,46,247,293,44,464,508,4990
Total (UTs),6 - Insult to the Modesty of Women_Total (Section 509 IPC),2014,263,3,1376,1379,1386,0,0,1,2,5,1,497,158,655,66,729,912,1214,655,0,12,1857,9,362,29,104,133,61,168,229,1486
Total (UTs),6.1 - At Office premises,2014,2,0,12,12,15,0,0,0,0,0,0,4,4,8,1,9,5,33,8,0,0,41,0,2,0,2,2,0,0,0,39
Total (UTs),6.2 - Other places related to work,2014,11,0,27,27,27,0,0,0,0,2,0,9,5,14,1,17,21,33,14,0,0,47,0,9,0,4,4,0,5,5,38
Total (UTs),6.3 - In Public Transport system,2014,4,0,8,8,8,0,0,0,0,0,0,4,4,8,2,10,2,7,8,0,0,15,2,4,0,1,1,0,3,3,9
Total (UTs),6.4 - in Other Places,2014,246,3,1329,1332,1336,0,0,1,2,3,1,480,145,625,62,693,884,1141,625,0,12,1754,7,347,29,97,126,61,160,221,1400
Total (UTs),7 - Cruelty by Husband or his Relatives (Section 498A),2014,3801,26,3313,3339,3339,0,0,0,61,39,0,194,823,1017,73,1190,5950,5403,1017,18,16,6386,91,877,7,150,157,3,717,720,5418
Total (UTs),8 - Importation of Girls from Foreign Country (Section 366B IPC),2014,0,0,0,0,0,0,0,0,0,0,0,0,0,0,0,0,0,0,0,0,0,0,0,0,0,0,0,0,0,0,0
Total (UTs),9 - Abetment of Suicides of Women u/s 306 IPC,2014,5,1,29,30,30,0,0,0,0,0,0,6,1,7,0,7,28,21,7,0,0,28,0,0,0,0,0,0,0,0,28
Total (UTs),"10 - Dowry Prohibition Act, 1961",2014,22,2,27,29,29,0,0,0,0,2,0,9,8,17,3,22,29,66,17,0,0,83,0,3,0,0,0,0,3,3,80
Total (UTs),"11 - Indecent Representation of Women (Prohibition) Act, 1986",2014,6,0,0,0,0,0,0,0,0,2,0,0,0,0,3,5,1,0,0,0,0,0,0,0,0,0,0,0,0,0,0
Total (UTs),12 - Commission of Sati Prevention Act 1987,2014,0,0,0,0,0,0,0,0,0,0,0,0,0,0,0,0,0,0,0,0,0,0,0,0,0,0,0,0,0,0,0
Total (UTs),"13 - Protection of Women from Domestic Violence Act, 2005",2014,0,0,7,7,7,0,0,0,0,0,0,2,0,2,0,2,5,0,2,0,0,2,0,1,0,1,1,0,0,0,1
Total (UTs),14 - Immoral Traffic (Prevention) Act (Women Cases only),2014,16,0,18,18,24,0,0,0,0,0,0,9,12,21,0,21,13,191,21,0,0,212,0,22,0,11,11,0,11,11,190
Total (UTs),14.1 - Under ITP Section 5,2014,10,0,15,15,21,0,0,0,0,0,0,8,7,15,0,15,10,68,15,0,0,83,0,4,0,2,2,0,2,2,79
Total (UTs),14.2 - Under ITP Section 6,2014,0,0,1,1,1,0,0,0,0,0,0,1,0,1,0,1,0,0,1,0,0,1,0,0,0,0,0,0,0,0,1
Total (UTs),14.3 - Under ITP Section 7,2014,0,0,0,0,0,0,0,0,0,0,0,0,0,0,0,0,0,0,0,0,0,0,0,0,0,0,0,0,0,0,0
Total (UTs),14.4 - Under ITP Section 8,2014,0,0,1,1,1,0,0,0,0,0,0,0,0,0,0,0,1,51,0,0,0,51,0,6,0,0,0,0,6,6,45
Total (UTs),14.5 - Other Sections under ITP Act,2014,6,0,1,1,1,0,0,0,0,0,0,0,5,5,0,5,2,72,5,0,0,77,0,12,0,9,9,0,3,3,65
Total (UTs),15 - Total Crimes against Women,2014,7950,120,15809,15929,16170,0,0,21,584,853,1,4143,2701,6844,1209,9491,14367,17950,6844,22,45,24727,130,3528,149,935,1084,231,2213,2444,21069
Total (All India),1 - Rape (Section 376 IPC),2014,15052,2473,34262,36735,36975,9,1,155,2540,768,19,22771,8069,30840,1423,35590,16032,94636,30840,3,40,125433,253,17649,866,4078,4944,2068,10637,12705,107531
Total (All India),1.1 - Custodial Rape,2014,3,5,192,197,197,0,0,0,3,8,0,155,3,158,8,177,23,17,158,0,0,175,0,5,0,3,3,0,2,2,170
Total (All India),1.1.1 - Custodial_Gang Rape,2014,0,0,7,7,7,0,0,0,1,0,0,5,0,5,0,6,1,1,5,0,0,6,0,1,0,1,1,0,0,0,5
Total (All India),1.1.2 - Custodial_Other Rape,2014,3,5,185,190,190,0,0,0,2,8,0,150,3,153,8,171,22,16,153,0,0,169,0,4,0,2,2,0,2,2,165
Total (All India),1.2 - Rape other than Custodial,2014,15049,2468,34070,36538,36778,9,1,155,2532,760,24,22616,8066,30682,1415,35413,16009,94619,30682,3,40,125258,253,17644,866,4075,4941,2068,10635,12703,107361
Total (All India),1.2.1 - Rape_Gang Rape,2014,211,151,2195,2346,2361,0,0,6,298,118,0,1373,151,1524,59,1999,552,1120,1524,0,0,2644,4,352,22,106,128,64,160,224,2288
Total (All India),1.2.2 - Rape_Others,2014,14838,2317,31875,34192,34417,9,1,149,2239,642,19,21243,7915,29158,1356,33414,15457,93499,29158,3,40,122614,249,17292,844,3969,4813,2004,10475,12479,105073
Total (All India),2 - Attempt to commit Rape (Section 376 & 511 IPC),2014,439,776,3458,4234,4234,0,0,1,323,74,14,2363,418,2781,177,3369,1303,2026,2781,0,1,4806,29,1016,57,92,149,150,717,867,3761
Total (All India),"3 - Kidnapping & Abduction of Women (Section 363,364,364A, 366-369 IPC)",2014,27496,2337,54974,57311,58492,27,2,95,6497,6594,292,16620,9424,26044,9723,49150,35533,83103,26044,9,103,109035,387,11791,291,2364,2655,1175,7961,9136,96857
Total (All India),3.1 - Kidnaping & Abduction Section 363 IPC,2014,6605,290,16726,17016,17561,2,0,40,2216,2213,50,4021,2077,6098,2789,13366,10213,18809,6098,0,4,24903,68,2492,59,555,614,195,1683,1878,22343
Total (All India),3.2 - Kidnaping & Abduction in order to Murder Section 364 IPC,2014,46,19,187,206,207,0,0,0,40,39,0,87,7,94,14,187,65,289,94,0,0,383,0,37,9,7,16,10,11,21,346
Total (All India),3.3 - Kidnapping for Ransom Section 364A,2014,63,1,90,91,91,0,0,1,2,2,0,39,18,57,2,63,90,185,57,0,0,242,0,9,0,2,2,1,6,7,233
Total (All India),3.4 - Kidnapping & Abduction of Women to compel her for marriage,2014,16980,1588,29286,30874,30957,24,2,29,2758,3550,167,9779,6043,15822,5881,28178,19621,50811,15822,0,99,66534,248,7781,185,1598,1783,800,5198,5998,58505
Total (All India),3.5 - Kidnapping & Abduction of Women-Other,2014,3802,439,8685,9124,9676,1,0,25,1481,790,75,2694,1279,3973,1037,7356,5544,13009,3973,9,0,16973,71,1472,38,202,240,169,1063,1232,15430
Total (All India),4 - Dowry Deaths (Section 304-B IPC),2014,4827,305,8150,8455,8501,0,0,12,180,240,45,4970,2683,7653,479,8597,4673,32843,7653,1,18,40477,161,5061,141,1531,1672,232,3157,3389,35255
Total (All India),5 - Assault on Women with intent to outrage her Modesty_Total (Section 354 IPC),2014,19011,3896,78339,82235,82620,2,1,80,4641,1661,171,54283,12179,66462,3453,76388,24775,192699,66462,12,1045,258104,3759,29995,1263,7159,8422,2674,18899,21573,224350
Total (All India),5.1 - Sexual Harassment,2014,2981,649,21289,21938,22019,1,1,22,766,392,41,15334,2227,17561,873,19633,5262,30568,17561,3,282,47844,1273,5103,361,1399,1760,796,2547,3343,41468
Total (All India),5.2 - Assault on women with intent to Disrobe,2014,646,313,6099,6412,6440,0,0,1,257,148,15,4101,348,4449,425,5294,1763,3375,4449,0,10,7814,126,762,34,122,156,133,473,606,6926
Total (All India),5.3 - Voyeurism,2014,157,20,654,674,679,0,0,0,21,7,0,425,46,471,21,520,311,324,471,0,2,793,8,67,4,20,24,19,24,43,718
Total (All India),5.4 - Stalking,2014,346,43,4656,4699,4709,0,0,4,109,50,2,3146,300,3446,141,3748,1293,1608,3446,0,15,5039,51,385,51,83,134,113,138,251,4603
Total (All India),5.5 - Others,2014,14881,2871,45641,48512,48773,1,0,53,3488,1064,113,31277,9258,40535,1993,47193,16146,156824,40535,9,736,196614,2301,23678,813,5535,6348,1613,15717,17330,170635
Total (All India),6 - Insult to the Modesty of Women_Total (Section 509 IPC),2014,3245,100,9635,9735,9796,0,0,10,469,79,16,5863,2281,8144,369,9077,3893,28702,8144,4,108,36734,1733,5778,296,916,1212,724,3842,4566,29223
Total (All India),6.1 - At Office premises,2014,15,0,57,57,60,0,0,0,2,0,0,32,10,42,1,45,27,167,42,0,0,209,2,9,0,2,2,0,7,7,198
Total (All India),6.2 - Other places related to work,2014,225,2,467,469,469,0,0,1,14,3,0,210,202,412,28,457,236,1453,412,0,1,1864,85,286,6,68,74,20,192,212,1493
Total (All India),6.3 - In Public Transport system,2014,27,2,119,121,121,0,0,2,6,0,0,51,51,102,16,124,22,379,102,0,0,481,10,61,4,11,15,5,41,46,410
Total (All India),6.4 - in Other Places,2014,2978,96,8992,9088,9146,0,0,7,447,76,16,5570,2018,7588,324,8451,3608,26703,7588,4,107,34180,1636,5422,286,835,1121,699,3602,4301,27122
Total (All India),7 - Cruelty by Husband or his Relatives (Section 498A),2014,46348,25369,97508,122877,123245,16,1,449,8144,4125,137,68151,28930,97081,8335,117822,50937,404790,97081,34,2195,499642,8911,46853,556,5869,6425,3872,36556,40428,443878
Total (All India),8 - Importation of Girls from Foreign Country (Section 366B IPC),2014,46,1,12,13,13,0,0,0,0,7,3,11,9,20,5,35,24,204,20,0,0,224,1,30,1,5,6,0,24,24,193
Total (All India),9 - Abetment of Suicides of Women u/s 306 IPC,2014,539,19,3715,3734,3747,0,0,6,97,29,11,1979,424,2403,58,2598,1669,6748,2403,0,0,9151,7,1014,45,109,154,62,798,860,8130
Total (All India),"10 - Dowry Prohibition Act, 1961",2014,5960,1400,8650,10050,10146,3,0,76,447,298,35,5355,3652,9007,983,10770,5161,22805,9007,0,71,31741,687,4617,30,442,472,310,3835,4145,26437
Total (All India),"11 - Indecent Representation of Women (Prohibition) Act, 1986",2014,58,0,47,47,47,0,0,0,2,3,0,33,21,54,7,66,39,926,54,0,0,980,1,169,1,78,79,0,90,90,810
Total (All India),12 - Commission of Sati Prevention Act 1987,2014,0,0,0,0,0,0,0,0,0,0,0,0,0,0,0,0,0,1,0,0,0,1,0,1,0,0,0,0,1,1,0
Total (All India),"13 - Protection of Women from Domestic Violence Act, 2005",2014,33,91,335,426,430,0,0,2,18,4,6,292,20,312,9,349,108,171,312,0,2,481,5,47,5,4,9,20,18,38,429
Total (All India),14 - Immoral Traffic (Prevention) Act (Women Cases only),2014,633,0,2070,2070,2756,0,0,1,3,7,1,1501,380,1881,19,1911,791,4734,1881,0,1,6614,3,949,251,210,461,38,450,488,5662
Total (All India),14.1 - Under ITP Section 5,2014,200,0,605,605,890,0,0,0,0,3,0,396,131,527,11,541,264,1259,527,0,0,1786,3,205,13,49,62,6,137,143,1578
Total (All India),14.2 - Under ITP Section 6,2014,9,0,81,81,121,0,0,0,0,0,0,64,9,73,0,73,17,113,73,0,0,186,0,17,1,4,5,0,12,12,169
Total (All India),14.3 - Under ITP Section 7,2014,25,0,120,120,143,0,0,0,0,0,0,84,22,106,1,107,38,433,106,0,0,539,0,30,1,10,11,2,17,19,509
Total (All India),14.4 - Under ITP Section 8,2014,4,0,104,104,114,0,0,0,2,0,0,90,3,93,0,95,13,403,93,0,0,496,0,70,31,22,53,0,17,17,426
Total (All India),14.5 - Other Sections under ITP Act,2014,395,0,1160,1160,1488,0,0,1,1,4,1,867,215,1082,7,1095,459,2526,1082,0,1,3607,0,627,205,125,330,30,267,297,2980
Total (All India),15 - Total Crimes against Women,2014,123687,36767,301155,337922,341002,57,5,887,23361,13889,750,184192,68490,252682,25040,315722,144938,874388,252682,63,3584,1123423,15937,124970,3803,22857,26660,11325,86985,98310,982516
